100 20
1 40 2 81 3 22 4 89 5 96 6 52 7 7 8 90 9 93 10 48 11 95 12 29 13 18 14 61 15 20 16 38 17 90 18 37 19 77 20 27
1 12 2 12 3 11 4 4 5 39 6 11 7 42 8 81 9 13 10 4 11 53 12 66 13 26 14 95 15 47 16 78 17 39 18 71 19 26 20 50
1 46 2 86 3 11 4 38 5 74 6 44 7 34 8 9 9 75 10 38 11 53 12 77 13 47 14 9 15 2 16 66 17 94 18 75 19 51 20 94
1 65 2 38 3 74 4 67 5 49 6 72 7 25 8 34 9 60 10 79 11 47 12 28 13 34 14 86 15 24 16 50 17 29 18 72 19 78 20 51
1 21 2 34 3 47 4 35 5 38 6 16 7 48 8 99 9 34 10 11 11 49 12 69 13 86 14 53 15 48 16 56 17 68 18 89 19 13 20 99
1 52 2 70 3 99 4 4 5 78 6 75 7 28 8 41 9 54 10 29 11 77 12 65 13 78 14 54 15 42 16 88 17 36 18 63 19 14 20 16
1 70 2 13 3 72 4 72 5 39 6 12 7 92 8 80 9 52 10 86 11 50 12 22 13 26 14 57 15 21 16 89 17 30 18 98 19 57 20 3
1 68 2 91 3 9 4 20 5 34 6 21 7 64 8 61 9 52 10 94 11 61 12 78 13 72 14 73 15 93 16 11 17 88 18 20 19 17 20 69
1 78 2 3 3 11 4 40 5 18 6 93 7 52 8 3 9 85 10 7 11 1 12 7 13 95 14 57 15 71 16 16 17 45 18 33 19 84 20 84
1 75 2 27 3 64 4 46 5 73 6 18 7 39 8 33 9 29 10 12 11 69 12 1 13 91 14 95 15 2 16 45 17 28 18 82 19 93 20 95
1 96 2 68 3 27 4 48 5 67 6 68 7 79 8 58 9 48 10 66 11 60 12 32 13 79 14 73 15 10 16 12 17 49 18 50 19 37 20 79
1 3 2 97 3 50 4 71 5 95 6 63 7 91 8 2 9 33 10 53 11 72 12 4 13 5 14 71 15 40 16 32 17 6 18 70 19 79 20 53
1 11 2 6 3 99 4 13 5 50 6 89 7 3 8 29 9 63 10 74 11 72 12 48 13 66 14 55 15 56 16 97 17 96 18 49 19 13 20 66
1 57 2 79 3 34 4 93 5 69 6 93 7 25 8 78 9 55 10 48 11 97 12 7 13 65 14 1 15 51 16 40 17 71 18 24 19 48 20 87
1 30 2 31 3 48 4 99 5 96 6 34 7 69 8 21 9 72 10 88 11 76 12 14 13 8 14 7 15 4 16 4 17 8 18 82 19 37 20 85
1 36 2 81 3 27 4 33 5 34 6 41 7 21 8 86 9 70 10 37 11 26 12 21 13 87 14 85 15 82 16 74 17 9 18 10 19 56 20 49
1 41 2 8 3 13 4 87 5 74 6 48 7 34 8 94 9 34 10 76 11 28 12 71 13 1 14 79 15 72 16 30 17 84 18 7 19 27 20 27
1 72 2 99 3 55 4 19 5 44 6 54 7 60 8 90 9 22 10 50 11 41 12 13 13 87 14 23 15 88 16 94 17 1 18 62 19 78 20 94
1 43 2 91 3 43 4 53 5 53 6 55 7 62 8 40 9 99 10 55 11 44 12 58 13 70 14 71 15 32 16 33 17 72 18 85 19 79 20 46
1 55 2 86 3 72 4 65 5 57 6 47 7 30 8 54 9 36 10 19 11 40 12 74 13 48 14 45 15 4 16 2 17 99 18 81 19 65 20 68
1 51 2 65 3 96 4 58 5 93 6 4 7 65 8 99 9 10 10 99 11 46 12 58 13 83 14 18 15 58 16 42 17 94 18 55 19 30 20 75
1 50 2 88 3 20 4 51 5 95 6 3 7 19 8 22 9 16 10 33 11 29 12 73 13 44 14 16 15 73 16 16 17 90 18 2 19 79 20 51
1 39 2 85 3 85 4 6 5 38 6 64 7 33 8 97 9 22 10 74 11 99 12 6 13 19 14 55 15 3 16 30 17 75 18 79 19 74 20 14
1 73 2 30 3 54 4 38 5 48 6 88 7 63 8 83 9 26 10 14 11 42 12 27 13 70 14 71 15 97 16 92 17 29 18 19 19 20 20 93
1 15 2 56 3 60 4 33 5 50 6 39 7 63 8 86 9 8 10 49 11 72 12 41 13 61 14 16 15 69 16 20 17 13 18 47 19 91 20 63
1 71 2 66 3 71 4 64 5 90 6 95 7 95 8 74 9 92 10 83 11 74 12 87 13 7 14 86 15 35 16 61 17 60 18 15 19 66 20 17
1 96 2 99 3 9 4 42 5 45 6 89 7 26 8 52 9 77 10 17 11 93 12 64 13 42 14 49 15 40 16 95 17 67 18 11 19 85 20 85
1 61 2 93 3 92 4 72 5 1 6 63 7 93 8 71 9 60 10 90 11 20 12 99 13 79 14 56 15 26 16 30 17 58 18 49 19 76 20 43
1 49 2 93 3 11 4 52 5 13 6 60 7 59 8 15 9 40 10 30 11 35 12 8 13 81 14 62 15 16 16 14 17 17 18 3 19 67 20 40
1 47 2 36 3 79 4 42 5 64 6 82 7 87 8 40 9 33 10 94 11 4 12 58 13 53 14 25 15 60 16 8 17 67 18 18 19 49 20 24
1 79 2 64 3 33 4 64 5 19 6 51 7 37 8 21 9 20 10 1 11 98 12 43 13 75 14 87 15 31 16 74 17 69 18 66 19 83 20 41
1 71 2 46 3 86 4 83 5 5 6 73 7 16 8 23 9 51 10 84 11 61 12 30 13 34 14 34 15 4 16 61 17 28 18 33 19 91 20 72
1 50 2 58 3 1 4 33 5 52 6 62 7 99 8 7 9 65 10 81 11 9 12 7 13 22 14 4 15 73 16 38 17 98 18 91 19 93 20 23
1 71 2 59 3 21 4 63 5 59 6 12 7 51 8 95 9 99 10 91 11 58 12 72 13 11 14 23 15 2 16 27 17 96 18 41 19 32 20 97
1 92 2 18 3 83 4 46 5 91 6 58 7 1 8 64 9 43 10 40 11 10 12 42 13 35 14 9 15 21 16 36 17 53 18 55 19 70 20 31
1 68 2 63 3 83 4 17 5 72 6 46 7 89 8 90 9 13 10 38 11 91 12 61 13 93 14 64 15 40 16 85 17 39 18 74 19 24 20 56
1 74 2 76 3 40 4 53 5 41 6 36 7 5 8 52 9 43 10 16 11 13 12 44 13 14 14 23 15 14 16 53 17 1 18 13 19 53 20 87
1 33 2 24 3 92 4 15 5 49 6 93 7 38 8 21 9 86 10 67 11 97 12 39 13 66 14 41 15 29 16 59 17 73 18 99 19 30 20 33
1 52 2 37 3 26 4 64 5 99 6 35 7 89 8 94 9 37 10 95 11 60 12 37 13 62 14 82 15 13 16 69 17 65 18 28 19 30 20 35
1 7 2 53 3 40 4 70 5 89 6 68 7 72 8 90 9 62 10 48 11 91 12 2 13 60 14 88 15 66 16 59 17 88 18 95 19 72 20 81
1 51 2 56 3 9 4 42 5 60 6 12 7 61 8 34 9 94 10 66 11 5 12 90 13 32 14 8 15 61 16 38 17 24 18 17 19 73 20 51
1 22 2 55 3 92 4 11 5 1 6 90 7 41 8 30 9 19 10 5 11 72 12 1 13 7 14 74 15 50 16 83 17 23 18 22 19 1 20 54
1 64 2 62 3 42 4 86 5 43 6 46 7 76 8 28 9 95 10 29 11 46 12 92 13 99 14 29 15 13 16 91 17 67 18 98 19 63 20 89
1 27 2 20 3 14 4 86 5 86 6 11 7 66 8 56 9 50 10 72 11 71 12 29 13 83 14 3 15 11 16 45 17 59 18 29 19 69 20 52
1 97 2 21 3 52 4 26 5 24 6 74 7 21 8 85 9 13 10 35 11 39 12 58 13 1 14 30 15 96 16 85 17 4 18 12 19 53 20 51
1 48 2 60 3 78 4 69 5 96 6 38 7 27 8 5 9 58 10 57 11 87 12 81 13 23 14 5 15 97 16 22 17 28 18 78 19 60 20 52
1 33 2 88 3 49 4 39 5 8 6 62 7 9 8 31 9 36 10 9 11 99 12 78 13 76 14 56 15 16 16 84 17 28 18 97 19 27 20 63
1 10 2 2 3 58 4 46 5 79 6 30 7 86 8 19 9 69 10 2 11 56 12 96 13 92 14 83 15 29 16 45 17 83 18 32 19 59 20 9
1 82 2 28 3 76 4 20 5 90 6 4 7 49 8 23 9 98 10 64 11 29 12 96 13 68 14 74 15 71 16 41 17 90 18 70 19 26 20 59
1 49 2 38 3 50 4 71 5 27 6 82 7 74 8 93 9 33 10 74 11 93 12 63 13 24 14 95 15 7 16 64 17 16 18 34 19 33 20 41
1 38 2 24 3 97 4 52 5 40 6 46 7 56 8 48 9 66 10 72 11 11 12 42 13 47 14 38 15 99 16 36 17 86 18 53 19 59 20 91
1 89 2 72 3 71 4 30 5 83 6 49 7 13 8 56 9 61 10 13 11 68 12 84 13 17 14 2 15 11 16 76 17 44 18 17 19 8 20 6
1 13 2 70 3 17 4 97 5 35 6 37 7 99 8 79 9 23 10 69 11 53 12 9 13 93 14 98 15 20 16 11 17 42 18 37 19 33 20 80
1 67 2 9 3 37 4 30 5 55 6 97 7 37 8 52 9 80 10 73 11 8 12 83 13 52 14 45 15 56 16 89 17 82 18 58 19 20 20 16
1 49 2 18 3 31 4 50 5 86 6 83 7 18 8 83 9 23 10 75 11 95 12 55 13 84 14 17 15 61 16 36 17 67 18 52 19 99 20 14
1 71 2 3 3 77 4 45 5 78 6 90 7 98 8 90 9 26 10 18 11 65 12 43 13 47 14 45 15 27 16 23 17 6 18 3 19 82 20 68
1 45 2 96 3 59 4 21 5 86 6 14 7 78 8 57 9 75 10 4 11 71 12 5 13 81 14 68 15 85 16 92 17 39 18 10 19 5 20 3
1 49 2 50 3 54 4 33 5 84 6 70 7 43 8 14 9 19 10 32 11 88 12 26 13 78 14 87 15 66 16 75 17 93 18 22 19 91 20 19
1 57 2 22 3 33 4 10 5 54 6 88 7 60 8 30 9 97 10 74 11 90 12 61 13 63 14 69 15 85 16 26 17 87 18 78 19 70 20 75
1 33 2 19 3 13 4 1 5 70 6 83 7 51 8 92 9 87 10 98 11 33 12 44 13 91 14 50 15 67 16 36 17 46 18 75 19 30 20 40
1 5 2 3 3 4 4 83 5 91 6 22 7 17 8 42 9 41 10 39 11 81 12 59 13 80 14 72 15 96 16 40 17 43 18 75 19 36 20 16
1 49 2 62 3 90 4 23 5 22 6 95 7 37 8 52 9 2 10 86 11 86 12 75 13 59 14 62 15 97 16 63 17 71 18 73 19 30 20 50
1 68 2 87 3 48 4 65 5 5 6 33 7 16 8 14 9 78 10 25 11 64 12 66 13 78 14 89 15 95 16 83 17 96 18 2 19 13 20 54
1 26 2 77 3 96 4 48 5 48 6 87 7 34 8 78 9 65 10 16 11 59 12 75 13 13 14 30 15 52 16 18 17 5 18 19 19 47 20 36
1 3 2 38 3 68 4 45 5 87 6 83 7 86 8 27 9 27 10 42 11 46 12 67 13 87 14 59 15 2 16 19 17 13 18 82 19 23 20 56
1 11 2 3 3 46 4 59 5 9 6 32 7 96 8 69 9 18 10 35 11 86 12 50 13 76 14 97 15 48 16 66 17 3 18 48 19 7 20 94
1 72 2 96 3 75 4 76 5 39 6 66 7 68 8 16 9 67 10 78 11 41 12 18 13 25 14 76 15 71 16 49 17 46 18 59 19 90 20 46
1 73 2 5 3 86 4 48 5 68 6 4 7 92 8 85 9 89 10 34 11 47 12 59 13 49 14 69 15 78 16 47 17 91 18 44 19 83 20 26
1 11 2 14 3 72 4 79 5 71 6 6 7 74 8 16 9 15 10 55 11 92 12 50 13 25 14 88 15 32 16 65 17 12 18 21 19 8 20 1
1 9 2 59 3 11 4 31 5 57 6 46 7 51 8 92 9 90 10 97 11 6 12 79 13 66 14 44 15 23 16 3 17 40 18 81 19 4 20 72
1 25 2 96 3 2 4 27 5 7 6 45 7 37 8 70 9 58 10 65 11 12 12 95 13 22 14 1 15 74 16 86 17 39 18 23 19 99 20 5
1 54 2 62 3 40 4 16 5 56 6 38 7 72 8 97 9 52 10 21 11 2 12 97 13 15 14 70 15 24 16 43 17 28 18 36 19 27 20 81
1 49 2 30 3 25 4 10 5 88 6 24 7 21 8 17 9 94 10 51 11 9 12 7 13 94 14 98 15 19 16 89 17 62 18 34 19 60 20 73
1 90 2 47 3 46 4 85 5 45 6 11 7 50 8 94 9 60 10 53 11 16 12 13 13 38 14 87 15 39 16 70 17 35 18 64 19 8 20 11
1 21 2 96 3 69 4 84 5 98 6 71 7 3 8 64 9 30 10 70 11 80 12 84 13 4 14 81 15 33 16 84 17 88 18 37 19 21 20 20
1 84 2 71 3 93 4 8 5 69 6 49 7 9 8 96 9 9 10 29 11 14 12 60 13 21 14 93 15 3 16 35 17 54 18 45 19 32 20 79
1 12 2 40 3 82 4 78 5 35 6 79 7 12 8 59 9 36 10 18 11 19 12 88 13 42 14 1 15 33 16 70 17 21 18 88 19 28 20 92
1 25 2 1 3 21 4 52 5 86 6 17 7 59 8 80 9 73 10 18 11 63 12 57 13 20 14 54 15 77 16 7 17 22 18 93 19 33 20 98
1 20 2 81 3 53 4 69 5 52 6 13 7 46 8 2 9 58 10 82 11 77 12 9 13 7 14 21 15 83 16 12 17 77 18 32 19 2 20 83
1 78 2 12 3 34 4 70 5 75 6 79 7 54 8 59 9 96 10 43 11 55 12 13 13 47 14 78 15 95 16 20 17 94 18 34 19 15 20 60
1 55 2 65 3 45 4 8 5 52 6 99 7 29 8 67 9 58 10 90 11 51 12 50 13 65 14 40 15 48 16 48 17 43 18 8 19 6 20 17
1 81 2 48 3 31 4 44 5 97 6 85 7 97 8 38 9 61 10 23 11 5 12 83 13 1 14 98 15 22 16 55 17 66 18 55 19 56 20 96
1 87 2 15 3 66 4 76 5 8 6 89 7 53 8 74 9 2 10 78 11 46 12 63 13 52 14 56 15 64 16 29 17 57 18 56 19 75 20 65
1 95 2 74 3 52 4 92 5 96 6 37 7 59 8 97 9 38 10 8 11 42 12 3 13 55 14 43 15 61 16 91 17 14 18 30 19 23 20 58
1 88 2 36 3 80 4 31 5 44 6 72 7 85 8 14 9 69 10 78 11 37 12 45 13 66 14 40 15 80 16 96 17 44 18 11 19 58 20 13
1 17 2 97 3 7 4 84 5 48 6 26 7 96 8 73 9 33 10 59 11 67 12 78 13 26 14 44 15 32 16 94 17 84 18 35 19 8 20 5
1 29 2 63 3 74 4 51 5 70 6 9 7 8 8 78 9 40 10 99 11 31 12 94 13 78 14 85 15 36 16 12 17 17 18 97 19 45 20 41
1 44 2 76 3 99 4 97 5 7 6 28 7 3 8 58 9 12 10 75 11 73 12 54 13 41 14 13 15 41 16 52 17 38 18 23 19 86 20 72
1 47 2 49 3 53 4 96 5 90 6 80 7 19 8 22 9 7 10 39 11 2 12 72 13 80 14 73 15 62 16 10 17 70 18 42 19 83 20 66
1 33 2 10 3 2 4 90 5 46 6 5 7 68 8 80 9 15 10 20 11 30 12 59 13 95 14 15 15 54 16 49 17 73 18 55 19 30 20 80
1 40 2 70 3 3 4 2 5 57 6 90 7 76 8 83 9 25 10 85 11 79 12 80 13 95 14 79 15 86 16 78 17 81 18 63 19 43 20 3
1 77 2 93 3 29 4 38 5 57 6 7 7 38 8 16 9 28 10 60 11 50 12 88 13 32 14 91 15 54 16 80 17 69 18 54 19 95 20 11
1 97 2 72 3 58 4 2 5 67 6 81 7 88 8 81 9 48 10 99 11 19 12 73 13 82 14 25 15 39 16 60 17 34 18 76 19 38 20 46
1 89 2 1 3 54 4 49 5 28 6 37 7 65 8 9 9 86 10 91 11 21 12 63 13 96 14 87 15 77 16 65 17 12 18 76 19 71 20 11
1 84 2 82 3 99 4 51 5 84 6 90 7 30 8 17 9 82 10 42 11 65 12 87 13 56 14 28 15 64 16 22 17 67 18 86 19 47 20 50
1 86 2 92 3 44 4 99 5 98 6 12 7 32 8 29 9 88 10 29 11 49 12 57 13 30 14 20 15 70 16 13 17 74 18 36 19 29 20 54
1 94 2 74 3 41 4 43 5 39 6 46 7 1 8 67 9 38 10 68 11 26 12 64 13 35 14 10 15 16 16 78 17 65 18 97 19 55 20 48
1 81 2 27 3 49 4 73 5 81 6 34 7 31 8 20 9 62 10 49 11 29 12 48 13 68 14 84 15 25 16 6 17 41 18 51 19 42 20 89
1 81 2 82 3 23 4 96 5 23 6 41 7 67 8 53 9 99 10 31 11 35 12 81 13 71 14 18 15 26 16 53 17 87 18 32 19 12 20 21
1 60 2 71 3 24 4 53 5 37 6 34 7 42 8 27 9 7 10 52 11 49 12 5 13 16 14 38 15 3 16 3 17 6 18 11 19 98 20 82
Reldue
-1	3320	-1	7
-1	2835	-1	1
-1	2039	-1	3
-1	3623	-1	10
-1	1183	-1	1
-1	3870	-1	7
-1	3259	-1	6
-1	3857	-1	1
-1	3001	-1	6
-1	2256	-1	1
-1	1164	-1	2
-1	2475	-1	8
-1	1786	-1	7
-1	3077	-1	6
-1	3333	-1	2
-1	2602	-1	6
-1	1255	-1	9
-1	2278	-1	1
-1	3650	-1	10
-1	3560	-1	9
-1	2495	-1	2
-1	2138	-1	6
-1	1991	-1	7
-1	2029	-1	10
-1	3497	-1	2
-1	2510	-1	2
-1	3480	-1	6
-1	3492	-1	5
-1	2481	-1	2
-1	2280	-1	2
-1	3345	-1	4
-1	3575	-1	2
-1	3683	-1	9
-1	3090	-1	10
-1	2378	-1	8
-1	3831	-1	3
-1	906	-1	8
-1	1879	-1	7
-1	3773	-1	4
-1	3841	-1	2
-1	949	-1	8
-1	2877	-1	6
-1	4641	-1	10
-1	2202	-1	2
-1	1637	-1	3
-1	1539	-1	2
-1	2128	-1	4
-1	1077	-1	4
-1	1558	-1	4
-1	4212	-1	6
-1	1278	-1	9
-1	1433	-1	6
-1	4054	-1	4
-1	2093	-1	8
-1	2946	-1	4
-1	3256	-1	6
-1	2915	-1	1
-1	1426	-1	6
-1	4910	-1	5
-1	4005	-1	10
-1	2409	-1	7
-1	1497	-1	4
-1	2934	-1	9
-1	3499	-1	10
-1	3262	-1	8
-1	3366	-1	5
-1	1330	-1	10
-1	4492	-1	8
-1	2732	-1	9
-1	1940	-1	10
-1	3470	-1	2
-1	3213	-1	6
-1	2476	-1	5
-1	1382	-1	7
-1	1432	-1	3
-1	1550	-1	5
-1	1274	-1	7
-1	3471	-1	5
-1	1285	-1	10
-1	1678	-1	9
-1	1138	-1	3
-1	2515	-1	10
-1	2223	-1	4
-1	1417	-1	7
-1	2915	-1	2
-1	2360	-1	6
-1	2347	-1	10
-1	2836	-1	3
-1	1788	-1	6
-1	2783	-1	1
-1	2339	-1	9
-1	1839	-1	6
-1	1409	-1	5
-1	2504	-1	5
-1	3423	-1	4
-1	4146	-1	5
-1	1871	-1	3
-1	1804	-1	2
-1	2443	-1	2
-1	2539	-1	3
