100 20
1 93 2 72 3 95 4 38 5 79 6 26 7 46 8 68 9 90 10 17 11 79 12 30 13 88 14 19 15 58 16 14 17 95 18 12 19 87 20 42
1 92 2 17 3 13 4 27 5 68 6 15 7 55 8 42 9 92 10 7 11 49 12 25 13 89 14 72 15 40 16 85 17 79 18 83 19 72 20 25
1 84 2 61 3 58 4 60 5 78 6 92 7 91 8 76 9 18 10 46 11 93 12 28 13 10 14 35 15 79 16 62 17 30 18 16 19 59 20 70
1 64 2 53 3 61 4 26 5 62 6 11 7 1 8 57 9 15 10 99 11 7 12 63 13 26 14 52 15 57 16 15 17 96 18 13 19 44 20 76
1 55 2 1 3 57 4 50 5 79 6 7 7 10 8 34 9 19 10 88 11 59 12 94 13 89 14 48 15 25 16 85 17 93 18 14 19 35 20 3
1 7 2 95 3 92 4 32 5 18 6 21 7 18 8 76 9 9 10 44 11 40 12 13 13 31 14 28 15 60 16 21 17 53 18 8 19 98 20 89
1 89 2 82 3 93 4 45 5 9 6 60 7 11 8 59 9 58 10 23 11 25 12 86 13 18 14 15 15 62 16 43 17 52 18 52 19 4 20 7
1 68 2 71 3 24 4 17 5 99 6 63 7 83 8 76 9 38 10 86 11 96 12 10 13 49 14 95 15 46 16 10 17 39 18 2 19 12 20 29
1 90 2 31 3 51 4 88 5 24 6 97 7 33 8 18 9 36 10 51 11 63 12 3 13 4 14 4 15 99 16 39 17 30 18 51 19 32 20 31
1 6 2 88 3 22 4 46 5 3 6 60 7 19 8 2 9 77 10 42 11 57 12 55 13 68 14 52 15 23 16 13 17 44 18 81 19 76 20 14
1 2 2 84 3 32 4 61 5 60 6 14 7 72 8 76 9 71 10 88 11 95 12 34 13 78 14 43 15 24 16 21 17 17 18 54 19 90 20 43
1 98 2 24 3 44 4 28 5 51 6 81 7 30 8 39 9 59 10 59 11 74 12 19 13 6 14 10 15 86 16 49 17 45 18 24 19 56 20 67
1 9 2 81 3 52 4 45 5 10 6 49 7 94 8 68 9 90 10 56 11 96 12 21 13 25 14 29 15 80 16 1 17 52 18 23 19 78 20 90
1 1 2 65 3 32 4 37 5 31 6 37 7 69 8 14 9 74 10 9 11 80 12 91 13 72 14 89 15 44 16 26 17 96 18 33 19 5 20 90
1 74 2 1 3 37 4 20 5 65 6 54 7 23 8 36 9 37 10 7 11 33 12 25 13 7 14 71 15 39 16 31 17 52 18 81 19 53 20 43
1 9 2 39 3 81 4 47 5 32 6 64 7 50 8 84 9 99 10 2 11 7 12 71 13 44 14 76 15 39 16 66 17 75 18 78 19 74 20 17
1 82 2 95 3 51 4 61 5 20 6 25 7 16 8 43 9 22 10 71 11 98 12 18 13 51 14 38 15 6 16 27 17 24 18 29 19 56 20 14
1 23 2 40 3 81 4 11 5 11 6 89 7 93 8 51 9 27 10 2 11 86 12 18 13 76 14 65 15 99 16 82 17 36 18 20 19 31 20 75
1 51 2 85 3 94 4 91 5 98 6 56 7 74 8 43 9 10 10 47 11 83 12 10 13 20 14 81 15 39 16 10 17 96 18 41 19 73 20 65
1 59 2 78 3 39 4 61 5 23 6 84 7 98 8 65 9 23 10 95 11 6 12 72 13 24 14 17 15 47 16 78 17 24 18 15 19 14 20 34
1 26 2 21 3 78 4 12 5 45 6 5 7 34 8 23 9 35 10 38 11 45 12 16 13 85 14 3 15 24 16 30 17 68 18 17 19 71 20 97
1 36 2 58 3 27 4 52 5 47 6 27 7 89 8 54 9 93 10 78 11 95 12 36 13 2 14 7 15 67 16 88 17 22 18 9 19 47 20 64
1 62 2 6 3 89 4 3 5 83 6 6 7 73 8 43 9 58 10 51 11 96 12 96 13 63 14 80 15 20 16 90 17 4 18 69 19 90 20 39
1 1 2 72 3 27 4 17 5 29 6 36 7 48 8 3 9 65 10 93 11 55 12 6 13 41 14 23 15 55 16 9 17 48 18 16 19 67 20 68
1 43 2 44 3 58 4 53 5 48 6 98 7 33 8 38 9 37 10 77 11 5 12 69 13 89 14 43 15 49 16 18 17 47 18 10 19 46 20 51
1 3 2 46 3 55 4 5 5 65 6 41 7 11 8 38 9 19 10 3 11 70 12 75 13 29 14 30 15 5 16 93 17 69 18 64 19 99 20 5
1 30 2 35 3 3 4 70 5 99 6 19 7 15 8 13 9 58 10 4 11 40 12 67 13 29 14 14 15 30 16 41 17 83 18 90 19 81 20 86
1 75 2 74 3 52 4 86 5 5 6 46 7 16 8 92 9 20 10 1 11 97 12 77 13 65 14 74 15 53 16 82 17 47 18 1 19 99 20 89
1 29 2 32 3 86 4 40 5 59 6 4 7 56 8 62 9 13 10 71 11 93 12 80 13 53 14 71 15 24 16 15 17 91 18 79 19 89 20 15
1 85 2 52 3 76 4 85 5 60 6 12 7 93 8 47 9 20 10 77 11 56 12 82 13 34 14 77 15 65 16 46 17 93 18 58 19 8 20 4
1 58 2 81 3 45 4 68 5 35 6 19 7 78 8 35 9 75 10 57 11 4 12 43 13 91 14 43 15 57 16 71 17 81 18 51 19 74 20 41
1 27 2 28 3 60 4 88 5 39 6 11 7 10 8 25 9 87 10 1 11 73 12 77 13 20 14 24 15 67 16 70 17 46 18 51 19 91 20 60
1 2 2 9 3 54 4 62 5 80 6 57 7 1 8 55 9 70 10 62 11 83 12 61 13 9 14 38 15 19 16 63 17 81 18 92 19 42 20 58
1 35 2 21 3 43 4 98 5 80 6 82 7 55 8 92 9 99 10 26 11 87 12 31 13 62 14 84 15 63 16 97 17 38 18 7 19 5 20 35
1 72 2 94 3 85 4 55 5 76 6 12 7 65 8 93 9 71 10 20 11 39 12 31 13 15 14 22 15 80 16 14 17 24 18 81 19 84 20 49
1 18 2 46 3 30 4 20 5 56 6 1 7 59 8 45 9 32 10 87 11 27 12 7 13 72 14 34 15 84 16 39 17 11 18 75 19 29 20 62
1 26 2 96 3 3 4 20 5 34 6 85 7 33 8 84 9 60 10 89 11 78 12 78 13 74 14 98 15 9 16 76 17 31 18 38 19 74 20 72
1 28 2 82 3 97 4 48 5 86 6 21 7 78 8 96 9 87 10 4 11 24 12 95 13 34 14 55 15 73 16 80 17 87 18 44 19 43 20 38
1 9 2 42 3 76 4 92 5 6 6 62 7 12 8 13 9 18 10 43 11 49 12 14 13 28 14 71 15 22 16 58 17 75 18 45 19 92 20 94
1 27 2 90 3 79 4 82 5 63 6 69 7 75 8 74 9 73 10 40 11 1 12 74 13 61 14 26 15 23 16 37 17 48 18 18 19 37 20 71
1 86 2 50 3 84 4 23 5 97 6 46 7 49 8 83 9 54 10 92 11 68 12 58 13 85 14 35 15 55 16 22 17 55 18 62 19 87 20 86
1 40 2 29 3 82 4 68 5 60 6 33 7 29 8 9 9 19 10 52 11 25 12 47 13 50 14 67 15 22 16 71 17 58 18 9 19 76 20 23
1 41 2 47 3 93 4 42 5 3 6 47 7 79 8 25 9 3 10 29 11 17 12 86 13 8 14 11 15 35 16 83 17 38 18 57 19 48 20 82
1 80 2 18 3 84 4 17 5 52 6 64 7 11 8 82 9 41 10 65 11 95 12 50 13 25 14 50 15 98 16 92 17 81 18 75 19 96 20 34
1 92 2 63 3 29 4 89 5 66 6 56 7 68 8 56 9 95 10 38 11 26 12 54 13 52 14 75 15 40 16 9 17 57 18 85 19 54 20 64
1 46 2 64 3 66 4 41 5 92 6 87 7 7 8 87 9 43 10 44 11 78 12 67 13 37 14 80 15 59 16 6 17 35 18 43 19 13 20 43
1 86 2 28 3 52 4 55 5 20 6 83 7 37 8 46 9 66 10 84 11 67 12 86 13 68 14 92 15 84 16 91 17 88 18 5 19 61 20 86
1 63 2 72 3 91 4 85 5 17 6 88 7 91 8 87 9 70 10 56 11 7 12 22 13 36 14 39 15 56 16 67 17 70 18 51 19 45 20 1
1 82 2 24 3 95 4 36 5 69 6 45 7 85 8 23 9 46 10 43 11 76 12 26 13 78 14 5 15 32 16 33 17 92 18 26 19 93 20 21
1 72 2 1 3 74 4 79 5 7 6 38 7 85 8 44 9 99 10 19 11 87 12 99 13 22 14 58 15 92 16 16 17 28 18 65 19 29 20 72
1 33 2 93 3 37 4 92 5 64 6 26 7 28 8 48 9 53 10 59 11 98 12 38 13 72 14 83 15 99 16 97 17 60 18 5 19 28 20 30
1 75 2 23 3 24 4 21 5 46 6 77 7 15 8 7 9 97 10 55 11 14 12 47 13 10 14 48 15 27 16 48 17 50 18 4 19 83 20 74
1 59 2 59 3 38 4 46 5 63 6 93 7 55 8 29 9 96 10 98 11 35 12 9 13 43 14 11 15 63 16 81 17 47 18 81 19 13 20 28
1 92 2 77 3 7 4 2 5 22 6 26 7 51 8 96 9 74 10 57 11 54 12 59 13 35 14 79 15 44 16 35 17 71 18 30 19 8 20 51
1 33 2 70 3 32 4 86 5 87 6 88 7 72 8 75 9 34 10 61 11 51 12 45 13 51 14 97 15 99 16 98 17 95 18 78 19 39 20 18
1 66 2 40 3 21 4 22 5 83 6 60 7 38 8 56 9 44 10 59 11 47 12 28 13 66 14 97 15 53 16 25 17 9 18 99 19 31 20 43
1 70 2 29 3 82 4 56 5 79 6 78 7 80 8 40 9 71 10 26 11 6 12 83 13 55 14 79 15 68 16 16 17 10 18 45 19 36 20 93
1 86 2 89 3 31 4 77 5 75 6 97 7 26 8 85 9 92 10 66 11 12 12 83 13 8 14 31 15 93 16 1 17 26 18 21 19 78 20 95
1 19 2 87 3 31 4 89 5 8 6 55 7 8 8 16 9 5 10 91 11 74 12 67 13 74 14 19 15 60 16 40 17 9 18 51 19 47 20 42
1 86 2 52 3 60 4 76 5 91 6 15 7 31 8 13 9 89 10 7 11 4 12 47 13 83 14 56 15 17 16 28 17 42 18 31 19 36 20 58
1 26 2 36 3 96 4 72 5 98 6 77 7 46 8 82 9 62 10 12 11 17 12 36 13 5 14 88 15 10 16 2 17 47 18 33 19 19 20 79
1 87 2 12 3 6 4 91 5 81 6 66 7 14 8 12 9 28 10 50 11 11 12 41 13 20 14 93 15 36 16 37 17 36 18 73 19 96 20 48
1 2 2 39 3 92 4 58 5 34 6 47 7 41 8 17 9 30 10 92 11 54 12 20 13 65 14 6 15 10 16 38 17 19 18 37 19 35 20 23
1 7 2 35 3 23 4 37 5 34 6 91 7 12 8 43 9 10 10 12 11 85 12 27 13 39 14 81 15 91 16 35 17 13 18 45 19 24 20 74
1 65 2 96 3 6 4 31 5 29 6 52 7 86 8 74 9 15 10 45 11 56 12 64 13 41 14 25 15 37 16 68 17 68 18 30 19 68 20 32
1 72 2 64 3 82 4 4 5 67 6 31 7 74 8 86 9 36 10 69 11 90 12 86 13 90 14 82 15 79 16 1 17 28 18 29 19 87 20 56
1 32 2 94 3 33 4 46 5 65 6 94 7 17 8 7 9 9 10 94 11 18 12 13 13 93 14 21 15 68 16 65 17 51 18 98 19 83 20 77
1 48 2 75 3 40 4 6 5 67 6 41 7 63 8 53 9 49 10 27 11 14 12 82 13 12 14 91 15 48 16 77 17 9 18 73 19 78 20 10
1 31 2 1 3 72 4 80 5 70 6 67 7 24 8 3 9 35 10 32 11 23 12 94 13 3 14 93 15 73 16 15 17 44 18 3 19 54 20 33
1 25 2 46 3 31 4 70 5 22 6 39 7 59 8 19 9 58 10 67 11 91 12 28 13 51 14 79 15 11 16 55 17 46 18 45 19 55 20 79
1 14 2 94 3 58 4 99 5 80 6 84 7 9 8 37 9 85 10 86 11 67 12 59 13 66 14 66 15 71 16 94 17 27 18 45 19 23 20 34
1 68 2 53 3 14 4 10 5 85 6 74 7 55 8 43 9 70 10 42 11 26 12 90 13 75 14 37 15 42 16 99 17 20 18 18 19 78 20 4
1 20 2 92 3 17 4 18 5 81 6 59 7 48 8 78 9 76 10 68 11 65 12 49 13 63 14 32 15 51 16 79 17 12 18 72 19 95 20 62
1 80 2 66 3 41 4 6 5 41 6 32 7 23 8 95 9 25 10 14 11 43 12 41 13 39 14 64 15 21 16 98 17 77 18 50 19 56 20 80
1 65 2 48 3 72 4 85 5 63 6 72 7 21 8 5 9 88 10 7 11 1 12 55 13 19 14 33 15 58 16 70 17 96 18 94 19 14 20 74
1 6 2 92 3 91 4 65 5 15 6 37 7 29 8 87 9 72 10 76 11 62 12 90 13 57 14 26 15 44 16 28 17 28 18 70 19 1 20 45
1 82 2 86 3 55 4 6 5 71 6 99 7 45 8 48 9 1 10 57 11 44 12 1 13 78 14 57 15 33 16 66 17 74 18 37 19 1 20 58
1 63 2 33 3 99 4 3 5 61 6 1 7 41 8 92 9 25 10 43 11 8 12 29 13 73 14 68 15 73 16 53 17 95 18 89 19 27 20 52
1 98 2 14 3 6 4 46 5 67 6 34 7 42 8 33 9 77 10 2 11 19 12 34 13 85 14 44 15 84 16 22 17 58 18 47 19 86 20 51
1 58 2 86 3 80 4 56 5 66 6 52 7 65 8 66 9 91 10 58 11 82 12 46 13 82 14 25 15 48 16 7 17 55 18 38 19 13 20 28
1 85 2 21 3 42 4 73 5 51 6 57 7 33 8 48 9 60 10 92 11 32 12 53 13 74 14 7 15 49 16 91 17 49 18 89 19 11 20 54
1 88 2 66 3 17 4 27 5 24 6 63 7 81 8 60 9 20 10 9 11 57 12 97 13 14 14 15 15 17 16 4 17 19 18 82 19 57 20 95
1 70 2 96 3 65 4 92 5 82 6 77 7 40 8 78 9 33 10 54 11 56 12 60 13 47 14 1 15 14 16 25 17 93 18 40 19 51 20 74
1 25 2 48 3 35 4 99 5 52 6 16 7 97 8 89 9 52 10 87 11 81 12 99 13 14 14 40 15 2 16 39 17 64 18 75 19 62 20 71
1 84 2 46 3 57 4 72 5 80 6 13 7 71 8 16 9 66 10 41 11 42 12 83 13 39 14 79 15 36 16 34 17 93 18 57 19 66 20 44
1 19 2 80 3 73 4 58 5 11 6 94 7 71 8 29 9 8 10 17 11 48 12 96 13 21 14 73 15 89 16 67 17 35 18 85 19 95 20 10
1 18 2 34 3 69 4 74 5 16 6 24 7 78 8 41 9 33 10 42 11 7 12 30 13 70 14 75 15 30 16 53 17 4 18 95 19 5 20 11
1 38 2 99 3 37 4 46 5 79 6 39 7 77 8 15 9 81 10 68 11 60 12 36 13 78 14 63 15 49 16 47 17 67 18 14 19 86 20 76
1 96 2 81 3 21 4 63 5 99 6 65 7 90 8 65 9 89 10 27 11 9 12 30 13 62 14 6 15 40 16 6 17 11 18 28 19 66 20 95
1 36 2 35 3 24 4 19 5 73 6 16 7 61 8 96 9 62 10 51 11 27 12 15 13 85 14 42 15 23 16 13 17 31 18 36 19 37 20 61
1 30 2 91 3 61 4 7 5 3 6 9 7 40 8 46 9 91 10 34 11 99 12 9 13 50 14 82 15 25 16 52 17 65 18 41 19 53 20 68
1 80 2 98 3 86 4 56 5 26 6 30 7 78 8 24 9 54 10 6 11 19 12 19 13 53 14 46 15 32 16 52 17 63 18 71 19 65 20 91
1 95 2 83 3 51 4 94 5 83 6 21 7 80 8 42 9 17 10 6 11 43 12 36 13 86 14 99 15 68 16 90 17 2 18 31 19 75 20 91
1 24 2 74 3 93 4 25 5 54 6 46 7 16 8 81 9 27 10 84 11 29 12 53 13 87 14 10 15 60 16 45 17 21 18 8 19 57 20 53
1 65 2 76 3 6 4 76 5 89 6 96 7 69 8 38 9 35 10 79 11 17 12 7 13 30 14 80 15 89 16 73 17 68 18 96 19 44 20 56
1 84 2 67 3 25 4 29 5 34 6 14 7 18 8 91 9 72 10 90 11 4 12 64 13 14 14 60 15 72 16 1 17 62 18 75 19 74 20 67
1 38 2 67 3 5 4 72 5 74 6 68 7 35 8 55 9 90 10 38 11 57 12 26 13 11 14 43 15 72 16 33 17 53 18 34 19 25 20 13
1 46 2 31 3 79 4 33 5 37 6 48 7 53 8 58 9 17 10 96 11 10 12 7 13 22 14 13 15 3 16 99 17 53 18 38 19 13 20 36
1 93 2 30 3 83 4 35 5 25 6 29 7 72 8 56 9 50 10 81 11 80 12 2 13 78 14 1 15 2 16 68 17 1 18 11 19 67 20 51
1 6 2 63 3 34 4 93 5 63 6 3 7 83 8 85 9 1 10 87 11 86 12 76 13 65 14 67 15 61 16 71 17 67 18 45 19 37 20 27
Reldue
-1	3467	-1	6
-1	4090	-1	1
-1	1586	-1	5
-1	1908	-1	4
-1	2505	-1	5
-1	2915	-1	5
-1	2347	-1	9
-1	3617	-1	8
-1	2286	-1	6
-1	1364	-1	2
-1	1595	-1	6
-1	1377	-1	9
-1	2773	-1	7
-1	1245	-1	4
-1	1759	-1	2
-1	2588	-1	3
-1	2395	-1	6
-1	1636	-1	7
-1	2876	-1	6
-1	2032	-1	5
-1	1998	-1	1
-1	1692	-1	1
-1	1534	-1	4
-1	799	-1	4
-1	2601	-1	10
-1	942	-1	8
-1	2504	-1	3
-1	3795	-1	7
-1	1899	-1	10
-1	3934	-1	5
-1	2734	-1	2
-1	2343	-1	2
-1	1890	-1	9
-1	2777	-1	1
-1	2249	-1	1
-1	3334	-1	1
-1	4466	-1	8
-1	1250	-1	5
-1	1284	-1	4
-1	3294	-1	8
-1	4898	-1	2
-1	2110	-1	8
-1	1569	-1	6
-1	4474	-1	8
-1	3923	-1	6
-1	1971	-1	4
-1	1519	-1	4
-1	4250	-1	1
-1	2573	-1	9
-1	3988	-1	6
-1	2575	-1	4
-1	891	-1	6
-1	2448	-1	7
-1	2208	-1	10
-1	3784	-1	8
-1	2425	-1	7
-1	1746	-1	8
-1	4071	-1	5
-1	3521	-1	10
-1	2948	-1	2
-1	1601	-1	10
-1	3549	-1	2
-1	2025	-1	10
-1	1959	-1	7
-1	1207	-1	4
-1	4827	-1	4
-1	1322	-1	4
-1	3454	-1	7
-1	1638	-1	8
-1	2627	-1	2
-1	2595	-1	6
-1	1399	-1	9
-1	4187	-1	7
-1	1799	-1	1
-1	2326	-1	2
-1	2623	-1	2
-1	2937	-1	8
-1	1884	-1	7
-1	2467	-1	9
-1	1501	-1	10
-1	2312	-1	5
-1	1611	-1	9
-1	3962	-1	4
-1	3892	-1	9
-1	1776	-1	5
-1	1429	-1	10
-1	2700	-1	3
-1	3265	-1	8
-1	2504	-1	10
-1	2427	-1	4
-1	2365	-1	1
-1	3358	-1	10
-1	2547	-1	7
-1	2161	-1	2
-1	3632	-1	7
-1	2790	-1	4
-1	1624	-1	5
-1	822	-1	2
-1	2696	-1	7
-1	3660	-1	10
