100 20
1 6 2 56 3 52 4 32 5 14 6 79 7 97 8 1 9 63 10 86 11 8 12 72 13 20 14 57 15 35 16 10 17 48 18 82 19 67 20 3
1 87 2 78 3 77 4 10 5 34 6 95 7 61 8 61 9 70 10 88 11 81 12 63 13 13 14 7 15 66 16 25 17 83 18 94 19 50 20 95
1 12 2 48 3 73 4 4 5 54 6 12 7 99 8 93 9 50 10 27 11 93 12 90 13 72 14 79 15 46 16 92 17 90 18 67 19 41 20 21
1 57 2 11 3 76 4 26 5 53 6 68 7 78 8 73 9 53 10 12 11 17 12 34 13 78 14 72 15 27 16 37 17 7 18 57 19 14 20 52
1 81 2 53 3 29 4 36 5 95 6 84 7 69 8 17 9 75 10 77 11 95 12 59 13 43 14 32 15 7 16 62 17 46 18 53 19 39 20 41
1 88 2 89 3 9 4 68 5 27 6 44 7 98 8 52 9 19 10 96 11 65 12 47 13 86 14 15 15 87 16 56 17 36 18 78 19 2 20 64
1 91 2 41 3 69 4 81 5 38 6 45 7 34 8 33 9 47 10 67 11 83 12 23 13 85 14 15 15 56 16 50 17 22 18 63 19 90 20 92
1 97 2 20 3 30 4 79 5 23 6 64 7 26 8 53 9 14 10 61 11 76 12 7 13 70 14 84 15 55 16 2 17 9 18 50 19 7 20 39
1 89 2 29 3 63 4 45 5 54 6 76 7 10 8 52 9 82 10 61 11 82 12 67 13 90 14 88 15 27 16 72 17 68 18 55 19 26 20 44
1 48 2 18 3 36 4 87 5 5 6 79 7 20 8 47 9 12 10 87 11 72 12 18 13 45 14 80 15 78 16 22 17 21 18 28 19 5 20 25
1 92 2 28 3 79 4 51 5 19 6 88 7 1 8 22 9 20 10 37 11 35 12 35 13 35 14 61 15 75 16 44 17 76 18 41 19 86 20 19
1 80 2 49 3 53 4 43 5 86 6 38 7 75 8 3 9 7 10 38 11 92 12 35 13 52 14 5 15 6 16 70 17 68 18 7 19 92 20 95
1 68 2 19 3 9 4 96 5 95 6 53 7 72 8 20 9 48 10 76 11 80 12 63 13 1 14 57 15 16 16 72 17 27 18 68 19 83 20 57
1 55 2 86 3 71 4 71 5 42 6 93 7 77 8 57 9 20 10 17 11 33 12 63 13 96 14 65 15 22 16 44 17 34 18 90 19 75 20 95
1 77 2 74 3 9 4 90 5 16 6 31 7 94 8 13 9 53 10 18 11 45 12 31 13 42 14 27 15 29 16 5 17 66 18 91 19 66 20 92
1 88 2 81 3 11 4 61 5 6 6 12 7 81 8 72 9 93 10 51 11 53 12 57 13 15 14 91 15 95 16 14 17 47 18 47 19 88 20 68
1 65 2 29 3 74 4 32 5 66 6 58 7 7 8 71 9 84 10 30 11 24 12 36 13 75 14 56 15 24 16 26 17 17 18 47 19 63 20 84
1 3 2 7 3 91 4 40 5 55 6 49 7 48 8 33 9 93 10 15 11 13 12 70 13 26 14 20 15 78 16 82 17 33 18 56 19 46 20 77
1 60 2 81 3 63 4 35 5 56 6 4 7 67 8 32 9 68 10 59 11 11 12 71 13 65 14 24 15 39 16 42 17 22 18 67 19 1 20 13
1 66 2 60 3 1 4 56 5 52 6 91 7 39 8 48 9 18 10 78 11 54 12 94 13 54 14 50 15 58 16 64 17 65 18 49 19 84 20 92
1 23 2 59 3 18 4 10 5 40 6 36 7 88 8 55 9 15 10 24 11 54 12 1 13 23 14 41 15 53 16 38 17 2 18 29 19 15 20 92
1 28 2 20 3 4 4 37 5 87 6 41 7 48 8 39 9 44 10 92 11 65 12 61 13 41 14 3 15 56 16 79 17 64 18 60 19 41 20 29
1 1 2 2 3 28 4 51 5 7 6 38 7 50 8 52 9 21 10 90 11 95 12 20 13 48 14 29 15 30 16 65 17 37 18 47 19 36 20 93
1 94 2 59 3 86 4 23 5 77 6 30 7 47 8 49 9 18 10 74 11 32 12 15 13 75 14 83 15 88 16 28 17 47 18 16 19 10 20 92
1 82 2 72 3 15 4 45 5 18 6 72 7 68 8 94 9 49 10 85 11 96 12 12 13 6 14 38 15 15 16 41 17 53 18 24 19 25 20 50
1 37 2 74 3 46 4 56 5 59 6 29 7 5 8 9 9 27 10 99 11 34 12 55 13 56 14 60 15 59 16 49 17 88 18 80 19 20 20 88
1 45 2 69 3 12 4 24 5 75 6 13 7 66 8 40 9 3 10 29 11 72 12 59 13 51 14 39 15 55 16 6 17 25 18 37 19 86 20 85
1 9 2 75 3 46 4 44 5 35 6 68 7 68 8 11 9 24 10 2 11 83 12 30 13 1 14 49 15 29 16 88 17 74 18 11 19 24 20 23
1 2 2 70 3 27 4 61 5 22 6 76 7 98 8 62 9 76 10 88 11 42 12 71 13 88 14 15 15 37 16 72 17 50 18 17 19 86 20 13
1 8 2 78 3 28 4 49 5 54 6 57 7 51 8 16 9 16 10 73 11 78 12 86 13 55 14 41 15 14 16 95 17 16 18 48 19 71 20 40
1 99 2 6 3 48 4 19 5 85 6 79 7 93 8 83 9 33 10 36 11 25 12 5 13 73 14 7 15 80 16 21 17 49 18 16 19 41 20 90
1 49 2 6 3 88 4 59 5 53 6 3 7 27 8 6 9 34 10 61 11 53 12 88 13 3 14 16 15 96 16 24 17 89 18 63 19 7 20 76
1 29 2 82 3 7 4 85 5 35 6 42 7 86 8 78 9 30 10 21 11 82 12 41 13 57 14 96 15 57 16 44 17 47 18 25 19 86 20 40
1 8 2 10 3 18 4 47 5 11 6 73 7 97 8 79 9 52 10 73 11 2 12 29 13 37 14 50 15 30 16 89 17 94 18 64 19 69 20 72
1 92 2 75 3 59 4 70 5 41 6 64 7 86 8 66 9 76 10 20 11 38 12 51 13 29 14 47 15 75 16 85 17 48 18 9 19 56 20 98
1 51 2 81 3 54 4 96 5 97 6 10 7 25 8 52 9 17 10 60 11 90 12 41 13 75 14 88 15 39 16 42 17 77 18 88 19 62 20 63
1 9 2 43 3 60 4 23 5 5 6 16 7 76 8 66 9 85 10 89 11 12 12 41 13 26 14 27 15 93 16 91 17 40 18 76 19 26 20 1
1 83 2 1 3 73 4 80 5 89 6 35 7 74 8 38 9 2 10 21 11 74 12 37 13 78 14 67 15 10 16 84 17 8 18 60 19 63 20 16
1 47 2 98 3 23 4 50 5 57 6 89 7 36 8 39 9 17 10 44 11 97 12 2 13 94 14 47 15 4 16 50 17 61 18 88 19 65 20 81
1 79 2 35 3 68 4 24 5 24 6 66 7 9 8 40 9 15 10 49 11 32 12 7 13 30 14 34 15 12 16 98 17 56 18 71 19 97 20 56
1 42 2 28 3 34 4 37 5 46 6 12 7 57 8 10 9 65 10 21 11 65 12 98 13 88 14 79 15 30 16 91 17 5 18 26 19 73 20 87
1 83 2 63 3 65 4 91 5 64 6 75 7 65 8 36 9 80 10 22 11 99 12 74 13 34 14 32 15 63 16 60 17 8 18 46 19 25 20 34
1 67 2 67 3 57 4 5 5 71 6 23 7 94 8 82 9 63 10 57 11 15 12 97 13 50 14 87 15 58 16 60 17 74 18 23 19 42 20 97
1 88 2 51 3 22 4 41 5 41 6 52 7 14 8 46 9 77 10 55 11 5 12 49 13 6 14 33 15 77 16 2 17 56 18 61 19 61 20 28
1 22 2 30 3 2 4 71 5 45 6 65 7 7 8 2 9 91 10 89 11 8 12 41 13 49 14 83 15 59 16 34 17 42 18 25 19 32 20 69
1 31 2 27 3 62 4 33 5 35 6 34 7 39 8 28 9 88 10 84 11 91 12 22 13 11 14 46 15 27 16 85 17 56 18 51 19 4 20 82
1 64 2 83 3 64 4 93 5 95 6 32 7 95 8 8 9 59 10 11 11 54 12 2 13 4 14 89 15 4 16 87 17 59 18 5 19 64 20 69
1 43 2 26 3 24 4 53 5 53 6 27 7 74 8 31 9 75 10 18 11 11 12 9 13 25 14 85 15 18 16 79 17 16 18 81 19 3 20 39
1 15 2 80 3 64 4 78 5 8 6 20 7 1 8 36 9 94 10 74 11 74 12 84 13 4 14 60 15 30 16 65 17 62 18 81 19 37 20 58
1 95 2 66 3 23 4 66 5 40 6 2 7 11 8 65 9 65 10 44 11 61 12 44 13 37 14 15 15 10 16 11 17 54 18 51 19 72 20 98
1 69 2 31 3 44 4 23 5 5 6 97 7 59 8 5 9 81 10 31 11 1 12 11 13 42 14 46 15 88 16 38 17 67 18 63 19 57 20 26
1 51 2 56 3 37 4 44 5 73 6 60 7 56 8 80 9 6 10 68 11 42 12 75 13 33 14 95 15 36 16 36 17 93 18 95 19 35 20 11
1 31 2 66 3 1 4 67 5 24 6 83 7 96 8 88 9 51 10 76 11 76 12 34 13 20 14 98 15 70 16 29 17 42 18 33 19 52 20 57
1 55 2 88 3 71 4 26 5 15 6 77 7 81 8 35 9 3 10 55 11 10 12 24 13 12 14 2 15 59 16 48 17 17 18 44 19 46 20 56
1 87 2 81 3 53 4 45 5 17 6 19 7 16 8 23 9 69 10 18 11 45 12 57 13 17 14 24 15 6 16 17 17 30 18 23 19 2 20 89
1 44 2 11 3 61 4 1 5 65 6 61 7 30 8 48 9 74 10 41 11 23 12 2 13 19 14 9 15 56 16 42 17 41 18 67 19 82 20 47
1 54 2 6 3 2 4 75 5 80 6 25 7 8 8 46 9 55 10 95 11 73 12 42 13 30 14 27 15 27 16 79 17 45 18 39 19 99 20 35
1 59 2 61 3 65 4 22 5 89 6 18 7 17 8 49 9 43 10 91 11 85 12 73 13 47 14 91 15 52 16 30 17 51 18 50 19 69 20 76
1 69 2 68 3 12 4 51 5 73 6 85 7 57 8 77 9 39 10 20 11 69 12 67 13 66 14 71 15 76 16 27 17 59 18 15 19 93 20 57
1 21 2 18 3 70 4 86 5 6 6 21 7 63 8 66 9 63 10 78 11 90 12 59 13 80 14 78 15 28 16 70 17 97 18 81 19 73 20 96
1 31 2 13 3 46 4 70 5 29 6 58 7 78 8 88 9 70 10 76 11 52 12 43 13 58 14 20 15 71 16 74 17 50 18 82 19 42 20 42
1 1 2 9 3 60 4 19 5 51 6 26 7 46 8 3 9 18 10 41 11 63 12 50 13 44 14 68 15 3 16 7 17 85 18 88 19 71 20 44
1 63 2 95 3 52 4 99 5 1 6 94 7 88 8 79 9 23 10 74 11 70 12 72 13 7 14 47 15 7 16 62 17 1 18 86 19 57 20 2
1 74 2 49 3 59 4 36 5 11 6 13 7 76 8 65 9 70 10 1 11 57 12 20 13 71 14 25 15 99 16 28 17 64 18 52 19 51 20 2
1 86 2 18 3 79 4 34 5 47 6 42 7 41 8 84 9 37 10 97 11 32 12 21 13 74 14 42 15 15 16 41 17 95 18 4 19 73 20 73
1 24 2 67 3 84 4 25 5 42 6 7 7 67 8 5 9 31 10 96 11 69 12 76 13 56 14 72 15 9 16 62 17 86 18 6 19 23 20 71
1 88 2 76 3 28 4 12 5 14 6 72 7 16 8 17 9 53 10 96 11 67 12 15 13 18 14 76 15 53 16 53 17 19 18 43 19 36 20 11
1 86 2 94 3 99 4 19 5 52 6 73 7 28 8 15 9 90 10 81 11 73 12 4 13 4 14 58 15 16 16 19 17 17 18 25 19 87 20 88
1 40 2 70 3 23 4 46 5 54 6 35 7 3 8 94 9 6 10 98 11 18 12 88 13 61 14 30 15 88 16 92 17 82 18 2 19 86 20 37
1 79 2 1 3 84 4 56 5 62 6 4 7 62 8 58 9 19 10 18 11 99 12 25 13 22 14 24 15 1 16 41 17 19 18 42 19 7 20 25
1 19 2 37 3 93 4 98 5 42 6 3 7 5 8 44 9 70 10 16 11 90 12 48 13 14 14 75 15 55 16 46 17 72 18 25 19 70 20 61
1 19 2 3 3 2 4 80 5 42 6 99 7 60 8 11 9 46 10 61 11 30 12 8 13 28 14 26 15 2 16 47 17 38 18 85 19 38 20 52
1 34 2 50 3 37 4 53 5 3 6 7 7 57 8 66 9 10 10 8 11 75 12 37 13 82 14 64 15 67 16 40 17 94 18 97 19 98 20 9
1 21 2 69 3 48 4 82 5 94 6 6 7 84 8 95 9 1 10 6 11 92 12 31 13 52 14 78 15 50 16 71 17 10 18 52 19 57 20 50
1 30 2 66 3 92 4 76 5 47 6 11 7 5 8 6 9 18 10 74 11 7 12 86 13 14 14 47 15 23 16 80 17 36 18 92 19 80 20 88
1 18 2 76 3 43 4 74 5 13 6 37 7 60 8 45 9 33 10 16 11 45 12 27 13 60 14 28 15 78 16 21 17 94 18 53 19 87 20 84
1 44 2 28 3 43 4 16 5 59 6 68 7 15 8 89 9 43 10 19 11 16 12 99 13 59 14 86 15 84 16 50 17 80 18 9 19 13 20 13
1 47 2 23 3 69 4 52 5 44 6 67 7 94 8 81 9 62 10 80 11 73 12 59 13 1 14 6 15 14 16 34 17 18 18 91 19 87 20 30
1 39 2 67 3 56 4 67 5 96 6 28 7 22 8 96 9 15 10 40 11 12 12 46 13 42 14 40 15 7 16 7 17 82 18 58 19 22 20 78
1 53 2 52 3 34 4 70 5 61 6 19 7 49 8 60 9 57 10 28 11 31 12 20 13 64 14 38 15 52 16 1 17 23 18 71 19 70 20 24
1 24 2 17 3 44 4 56 5 78 6 73 7 53 8 29 9 36 10 50 11 64 12 44 13 31 14 45 15 43 16 52 17 58 18 2 19 95 20 62
1 50 2 23 3 36 4 64 5 76 6 31 7 1 8 42 9 86 10 32 11 61 12 34 13 2 14 45 15 39 16 73 17 30 18 65 19 83 20 68
1 50 2 60 3 6 4 94 5 89 6 50 7 90 8 90 9 33 10 57 11 24 12 26 13 85 14 52 15 91 16 10 17 37 18 22 19 62 20 36
1 38 2 50 3 40 4 30 5 11 6 4 7 76 8 12 9 26 10 85 11 99 12 64 13 24 14 89 15 53 16 40 17 67 18 42 19 2 20 55
1 45 2 26 3 62 4 73 5 16 6 35 7 19 8 74 9 61 10 80 11 81 12 51 13 80 14 58 15 95 16 16 17 43 18 98 19 91 20 35
1 85 2 2 3 94 4 11 5 15 6 31 7 54 8 53 9 99 10 5 11 54 12 47 13 68 14 53 15 2 16 42 17 28 18 15 19 4 20 29
1 74 2 65 3 83 4 24 5 11 6 10 7 44 8 29 9 48 10 61 11 69 12 84 13 21 14 29 15 3 16 57 17 11 18 43 19 24 20 73
1 72 2 64 3 53 4 70 5 31 6 27 7 18 8 67 9 56 10 14 11 20 12 17 13 8 14 8 15 86 16 66 17 37 18 57 19 67 20 15
1 42 2 79 3 25 4 36 5 98 6 7 7 44 8 27 9 89 10 82 11 41 12 46 13 72 14 84 15 95 16 23 17 38 18 80 19 50 20 41
1 38 2 17 3 49 4 59 5 71 6 99 7 50 8 63 9 86 10 78 11 15 12 70 13 52 14 99 15 10 16 94 17 2 18 27 19 91 20 55
1 54 2 52 3 58 4 94 5 96 6 78 7 17 8 52 9 77 10 9 11 37 12 76 13 26 14 86 15 93 16 52 17 30 18 43 19 78 20 94
1 34 2 78 3 38 4 79 5 53 6 80 7 31 8 56 9 81 10 60 11 48 12 61 13 2 14 49 15 73 16 52 17 35 18 67 19 4 20 4
1 58 2 18 3 1 4 77 5 27 6 88 7 62 8 69 9 12 10 92 11 49 12 18 13 66 14 2 15 38 16 53 17 29 18 27 19 30 20 95
1 74 2 86 3 73 4 71 5 6 6 33 7 33 8 49 9 70 10 75 11 80 12 29 13 90 14 68 15 68 16 93 17 50 18 21 19 21 20 94
1 87 2 20 3 37 4 31 5 70 6 6 7 25 8 67 9 78 10 44 11 49 12 52 13 28 14 46 15 36 16 29 17 79 18 28 19 98 20 92
1 69 2 74 3 73 4 30 5 43 6 86 7 81 8 72 9 11 10 73 11 95 12 55 13 99 14 71 15 45 16 66 17 75 18 99 19 51 20 3
1 37 2 72 3 96 4 75 5 32 6 86 7 39 8 21 9 1 10 22 11 21 12 69 13 23 14 36 15 38 16 51 17 73 18 19 19 4 20 77
1 47 2 96 3 72 4 24 5 60 6 86 7 14 8 27 9 2 10 41 11 63 12 10 13 14 14 51 15 97 16 50 17 49 18 52 19 9 20 39
1 33 2 75 3 67 4 65 5 49 6 96 7 44 8 96 9 32 10 42 11 65 12 80 13 82 14 89 15 71 16 37 17 75 18 35 19 96 20 15
1 79 2 92 3 67 4 37 5 13 6 25 7 29 8 8 9 44 10 32 11 73 12 49 13 63 14 91 15 70 16 33 17 49 18 18 19 87 20 50
Reldue
-1	1117	-1	6
-1	3508	-1	7
-1	3299	-1	2
-1	1041	-1	1
-1	1743	-1	6
-1	2721	-1	4
-1	4004	-1	2
-1	2150	-1	2
-1	1615	-1	7
-1	1627	-1	4
-1	3047	-1	10
-1	2430	-1	9
-1	2233	-1	3
-1	1351	-1	3
-1	1281	-1	3
-1	1762	-1	10
-1	1484	-1	10
-1	2792	-1	7
-1	2146	-1	7
-1	3589	-1	4
-1	1460	-1	9
-1	3110	-1	5
-1	1397	-1	4
-1	3216	-1	4
-1	1872	-1	10
-1	3002	-1	5
-1	2539	-1	9
-1	1510	-1	1
-1	2215	-1	10
-1	3427	-1	3
-1	3222	-1	2
-1	1390	-1	6
-1	3919	-1	4
-1	1845	-1	7
-1	4213	-1	3
-1	1583	-1	5
-1	1323	-1	9
-1	3834	-1	1
-1	3323	-1	6
-1	2798	-1	7
-1	3554	-1	3
-1	2025	-1	9
-1	1882	-1	1
-1	1817	-1	7
-1	1984	-1	8
-1	2780	-1	2
-1	1322	-1	4
-1	1139	-1	1
-1	2396	-1	5
-1	2875	-1	8
-1	3460	-1	7
-1	1203	-1	9
-1	2238	-1	5
-1	1287	-1	2
-1	796	-1	7
-1	2705	-1	4
-1	3523	-1	1
-1	3951	-1	6
-1	3812	-1	10
-1	2059	-1	8
-1	2332	-1	8
-1	897	-1	10
-1	3435	-1	3
-1	3438	-1	8
-1	2652	-1	6
-1	2550	-1	10
-1	2498	-1	3
-1	2310	-1	9
-1	3086	-1	9
-1	789	-1	6
-1	1972	-1	9
-1	2242	-1	1
-1	2829	-1	5
-1	2057	-1	2
-1	1152	-1	10
-1	2836	-1	4
-1	2662	-1	8
-1	2915	-1	4
-1	2782	-1	7
-1	1108	-1	6
-1	2754	-1	6
-1	3008	-1	6
-1	3544	-1	6
-1	2671	-1	9
-1	3283	-1	9
-1	1267	-1	5
-1	2602	-1	10
-1	853	-1	6
-1	2828	-1	5
-1	1431	-1	6
-1	3713	-1	4
-1	2815	-1	2
-1	1258	-1	1
-1	2651	-1	6
-1	2794	-1	6
-1	1455	-1	2
-1	1926	-1	4
-1	1285	-1	7
-1	4578	-1	4
-1	1593	-1	3
