100 20
1 93 2 44 3 3 4 27 5 3 6 13 7 54 8 74 9 4 10 64 11 8 12 94 13 38 14 3 15 30 16 72 17 26 18 76 19 34 20 27
1 90 2 48 3 50 4 33 5 58 6 18 7 5 8 49 9 10 10 7 11 81 12 27 13 6 14 54 15 77 16 96 17 3 18 73 19 67 20 51
1 26 2 41 3 40 4 54 5 60 6 95 7 8 8 76 9 37 10 50 11 25 12 15 13 82 14 44 15 78 16 61 17 54 18 56 19 81 20 17
1 75 2 69 3 45 4 18 5 78 6 41 7 11 8 30 9 49 10 11 11 11 12 39 13 73 14 55 15 36 16 86 17 4 18 27 19 17 20 57
1 17 2 12 3 15 4 13 5 65 6 34 7 50 8 62 9 53 10 29 11 1 12 3 13 79 14 52 15 55 16 52 17 65 18 54 19 91 20 11
1 89 2 97 3 6 4 58 5 51 6 83 7 30 8 72 9 69 10 7 11 25 12 1 13 55 14 21 15 92 16 47 17 45 18 76 19 11 20 73
1 89 2 52 3 11 4 28 5 69 6 87 7 34 8 17 9 38 10 47 11 70 12 70 13 3 14 5 15 19 16 6 17 76 18 85 19 64 20 16
1 96 2 72 3 66 4 74 5 48 6 43 7 30 8 47 9 42 10 58 11 81 12 68 13 86 14 92 15 42 16 3 17 26 18 19 19 60 20 80
1 10 2 43 3 42 4 27 5 15 6 53 7 77 8 28 9 68 10 59 11 85 12 12 13 47 14 59 15 34 16 93 17 75 18 42 19 95 20 62
1 71 2 33 3 50 4 31 5 72 6 70 7 93 8 2 9 34 10 15 11 96 12 32 13 87 14 63 15 88 16 93 17 17 18 62 19 12 20 42
1 93 2 77 3 82 4 91 5 21 6 33 7 32 8 33 9 68 10 4 11 3 12 71 13 4 14 74 15 43 16 67 17 55 18 68 19 71 20 66
1 71 2 98 3 81 4 65 5 13 6 52 7 84 8 33 9 74 10 48 11 47 12 23 13 84 14 90 15 46 16 29 17 21 18 66 19 34 20 10
1 47 2 25 3 11 4 33 5 29 6 5 7 55 8 1 9 67 10 62 11 77 12 43 13 36 14 28 15 59 16 59 17 2 18 65 19 62 20 40
1 56 2 95 3 49 4 26 5 49 6 40 7 15 8 94 9 49 10 63 11 3 12 10 13 16 14 33 15 68 16 65 17 35 18 32 19 17 20 69
1 88 2 86 3 3 4 48 5 2 6 93 7 44 8 59 9 40 10 91 11 37 12 91 13 64 14 96 15 74 16 54 17 6 18 42 19 87 20 68
1 22 2 76 3 20 4 33 5 97 6 32 7 66 8 29 9 52 10 16 11 68 12 77 13 16 14 78 15 17 16 76 17 44 18 64 19 19 20 71
1 57 2 8 3 11 4 47 5 16 6 92 7 91 8 26 9 27 10 36 11 57 12 28 13 66 14 4 15 20 16 86 17 16 18 24 19 34 20 3
1 37 2 28 3 11 4 61 5 80 6 24 7 36 8 71 9 97 10 40 11 34 12 36 13 89 14 82 15 1 16 14 17 85 18 93 19 63 20 7
1 66 2 47 3 98 4 15 5 5 6 27 7 84 8 81 9 57 10 96 11 27 12 16 13 60 14 2 15 88 16 21 17 39 18 13 19 89 20 32
1 1 2 19 3 95 4 79 5 73 6 82 7 86 8 40 9 64 10 53 11 26 12 22 13 58 14 51 15 27 16 67 17 58 18 31 19 69 20 47
1 60 2 73 3 69 4 14 5 59 6 96 7 17 8 76 9 93 10 32 11 84 12 17 13 36 14 5 15 66 16 31 17 4 18 45 19 6 20 24
1 94 2 45 3 78 4 6 5 58 6 51 7 63 8 8 9 53 10 18 11 5 12 41 13 72 14 62 15 41 16 99 17 26 18 66 19 70 20 50
1 71 2 46 3 24 4 20 5 56 6 42 7 48 8 74 9 27 10 37 11 9 12 97 13 81 14 65 15 29 16 16 17 29 18 57 19 55 20 86
1 19 2 4 3 98 4 42 5 16 6 99 7 38 8 75 9 74 10 74 11 56 12 3 13 43 14 14 15 82 16 48 17 48 18 38 19 36 20 86
1 7 2 17 3 69 4 74 5 75 6 54 7 73 8 38 9 61 10 68 11 34 12 76 13 19 14 90 15 52 16 85 17 9 18 14 19 60 20 71
1 69 2 97 3 66 4 50 5 16 6 8 7 58 8 86 9 19 10 51 11 27 12 59 13 34 14 39 15 24 16 87 17 60 18 57 19 91 20 52
1 77 2 90 3 55 4 74 5 18 6 41 7 26 8 64 9 65 10 68 11 75 12 40 13 55 14 21 15 88 16 80 17 2 18 47 19 22 20 97
1 35 2 59 3 6 4 23 5 61 6 39 7 81 8 84 9 61 10 46 11 75 12 5 13 46 14 11 15 3 16 59 17 14 18 64 19 99 20 4
1 27 2 87 3 63 4 61 5 57 6 42 7 57 8 98 9 21 10 84 11 65 12 94 13 28 14 56 15 33 16 94 17 10 18 69 19 23 20 22
1 11 2 54 3 20 4 55 5 15 6 95 7 10 8 35 9 49 10 30 11 96 12 25 13 95 14 46 15 73 16 45 17 83 18 66 19 19 20 48
1 33 2 2 3 69 4 70 5 29 6 58 7 74 8 83 9 63 10 52 11 43 12 68 13 47 14 42 15 59 16 61 17 74 18 15 19 98 20 66
1 32 2 9 3 42 4 40 5 54 6 84 7 84 8 1 9 66 10 65 11 68 12 20 13 88 14 26 15 39 16 26 17 47 18 91 19 3 20 1
1 90 2 71 3 55 4 75 5 85 6 6 7 1 8 71 9 43 10 3 11 35 12 33 13 51 14 35 15 19 16 19 17 33 18 26 19 1 20 79
1 14 2 5 3 43 4 98 5 32 6 53 7 48 8 86 9 49 10 28 11 36 12 17 13 65 14 61 15 7 16 92 17 4 18 6 19 19 20 80
1 30 2 88 3 72 4 20 5 76 6 72 7 1 8 50 9 76 10 33 11 89 12 40 13 79 14 79 15 16 16 1 17 53 18 55 19 80 20 74
1 68 2 3 3 61 4 77 5 8 6 76 7 33 8 24 9 75 10 92 11 64 12 56 13 32 14 36 15 66 16 45 17 29 18 14 19 67 20 7
1 4 2 9 3 98 4 68 5 24 6 56 7 81 8 99 9 9 10 58 11 69 12 22 13 43 14 89 15 17 16 68 17 79 18 72 19 78 20 1
1 91 2 9 3 43 4 86 5 44 6 39 7 31 8 4 9 95 10 30 11 5 12 5 13 25 14 98 15 2 16 93 17 25 18 23 19 15 20 85
1 66 2 99 3 3 4 79 5 17 6 18 7 84 8 96 9 45 10 88 11 56 12 31 13 94 14 67 15 33 16 2 17 11 18 64 19 67 20 67
1 82 2 56 3 66 4 50 5 42 6 89 7 29 8 62 9 67 10 97 11 44 12 92 13 76 14 11 15 43 16 51 17 22 18 10 19 80 20 88
1 45 2 61 3 31 4 79 5 4 6 96 7 11 8 45 9 59 10 31 11 70 12 33 13 65 14 79 15 88 16 24 17 16 18 96 19 83 20 90
1 40 2 17 3 75 4 61 5 75 6 35 7 64 8 5 9 11 10 32 11 89 12 21 13 80 14 17 15 18 16 25 17 73 18 53 19 36 20 24
1 38 2 56 3 71 4 52 5 15 6 87 7 59 8 56 9 32 10 90 11 14 12 5 13 58 14 45 15 20 16 20 17 61 18 19 19 27 20 57
1 85 2 11 3 13 4 31 5 34 6 62 7 58 8 57 9 24 10 64 11 77 12 10 13 91 14 26 15 9 16 83 17 33 18 6 19 73 20 92
1 60 2 2 3 12 4 52 5 62 6 48 7 72 8 46 9 57 10 90 11 1 12 68 13 51 14 74 15 84 16 24 17 72 18 98 19 50 20 73
1 74 2 72 3 98 4 33 5 89 6 75 7 29 8 15 9 66 10 47 11 32 12 85 13 97 14 68 15 68 16 82 17 19 18 84 19 91 20 89
1 13 2 2 3 14 4 62 5 94 6 18 7 24 8 46 9 21 10 77 11 88 12 50 13 54 14 73 15 99 16 53 17 97 18 57 19 81 20 90
1 70 2 59 3 11 4 68 5 52 6 84 7 37 8 26 9 16 10 56 11 32 12 44 13 53 14 78 15 63 16 14 17 21 18 5 19 25 20 72
1 54 2 37 3 46 4 64 5 26 6 9 7 11 8 82 9 84 10 46 11 10 12 11 13 72 14 4 15 47 16 30 17 93 18 41 19 95 20 60
1 98 2 63 3 7 4 40 5 45 6 1 7 98 8 48 9 38 10 57 11 53 12 89 13 81 14 50 15 3 16 45 17 55 18 38 19 21 20 25
1 28 2 54 3 42 4 62 5 30 6 48 7 87 8 26 9 83 10 88 11 79 12 20 13 37 14 23 15 75 16 12 17 50 18 3 19 81 20 62
1 12 2 4 3 44 4 54 5 33 6 44 7 2 8 19 9 9 10 25 11 19 12 87 13 25 14 83 15 92 16 91 17 29 18 37 19 2 20 99
1 32 2 41 3 33 4 30 5 56 6 83 7 26 8 99 9 43 10 57 11 85 12 39 13 70 14 71 15 15 16 29 17 22 18 25 19 83 20 57
1 29 2 10 3 78 4 36 5 68 6 83 7 19 8 22 9 99 10 22 11 50 12 22 13 69 14 25 15 10 16 46 17 94 18 68 19 35 20 92
1 38 2 28 3 59 4 75 5 31 6 18 7 4 8 59 9 40 10 2 11 6 12 82 13 57 14 8 15 48 16 56 17 90 18 72 19 36 20 15
1 72 2 44 3 88 4 26 5 70 6 62 7 54 8 80 9 20 10 8 11 6 12 62 13 49 14 11 15 90 16 12 17 60 18 92 19 1 20 26
1 25 2 46 3 40 4 63 5 11 6 20 7 36 8 58 9 88 10 93 11 36 12 84 13 78 14 87 15 10 16 81 17 34 18 64 19 63 20 73
1 75 2 76 3 77 4 73 5 74 6 8 7 99 8 30 9 77 10 69 11 79 12 59 13 51 14 63 15 58 16 62 17 8 18 42 19 88 20 35
1 7 2 42 3 83 4 41 5 77 6 87 7 76 8 94 9 59 10 73 11 46 12 43 13 55 14 19 15 65 16 50 17 61 18 57 19 27 20 25
1 47 2 36 3 36 4 56 5 3 6 39 7 69 8 84 9 68 10 17 11 90 12 43 13 12 14 82 15 12 16 75 17 72 18 34 19 2 20 25
1 75 2 66 3 9 4 52 5 97 6 75 7 94 8 89 9 90 10 91 11 17 12 24 13 23 14 34 15 53 16 88 17 11 18 12 19 95 20 92
1 47 2 70 3 84 4 12 5 93 6 52 7 60 8 66 9 54 10 55 11 4 12 85 13 40 14 44 15 38 16 11 17 96 18 40 19 69 20 69
1 9 2 25 3 19 4 37 5 86 6 17 7 84 8 74 9 85 10 66 11 16 12 48 13 80 14 95 15 52 16 27 17 49 18 73 19 67 20 43
1 4 2 30 3 69 4 82 5 32 6 57 7 11 8 26 9 45 10 88 11 51 12 64 13 27 14 11 15 12 16 42 17 35 18 81 19 61 20 32
1 38 2 50 3 31 4 12 5 7 6 8 7 1 8 8 9 90 10 12 11 34 12 36 13 17 14 64 15 38 16 54 17 95 18 19 19 84 20 3
1 87 2 45 3 68 4 50 5 74 6 6 7 36 8 19 9 46 10 69 11 17 12 58 13 69 14 83 15 13 16 14 17 44 18 94 19 83 20 58
1 79 2 52 3 7 4 19 5 90 6 6 7 16 8 5 9 62 10 80 11 17 12 64 13 79 14 25 15 64 16 66 17 78 18 90 19 97 20 23
1 36 2 88 3 9 4 38 5 41 6 80 7 62 8 8 9 51 10 33 11 25 12 95 13 83 14 36 15 92 16 22 17 87 18 4 19 37 20 52
1 91 2 21 3 25 4 85 5 65 6 6 7 46 8 74 9 81 10 30 11 62 12 68 13 65 14 26 15 64 16 9 17 20 18 96 19 99 20 40
1 83 2 29 3 39 4 16 5 78 6 79 7 91 8 71 9 86 10 13 11 33 12 17 13 48 14 23 15 17 16 35 17 80 18 65 19 76 20 14
1 58 2 57 3 44 4 82 5 24 6 59 7 33 8 48 9 4 10 10 11 82 12 27 13 60 14 76 15 65 16 39 17 95 18 66 19 58 20 65
1 7 2 54 3 35 4 54 5 63 6 52 7 83 8 76 9 24 10 88 11 12 12 46 13 24 14 18 15 71 16 2 17 6 18 4 19 13 20 81
1 5 2 47 3 48 4 68 5 24 6 2 7 87 8 19 9 6 10 27 11 35 12 63 13 1 14 82 15 32 16 46 17 75 18 10 19 72 20 90
1 75 2 17 3 20 4 71 5 1 6 37 7 18 8 29 9 63 10 45 11 84 12 81 13 58 14 31 15 22 16 80 17 43 18 34 19 99 20 20
1 29 2 81 3 53 4 50 5 29 6 5 7 93 8 57 9 72 10 71 11 86 12 88 13 19 14 63 15 81 16 8 17 45 18 3 19 15 20 83
1 71 2 12 3 97 4 98 5 12 6 88 7 51 8 75 9 51 10 61 11 7 12 63 13 74 14 63 15 42 16 8 17 11 18 15 19 59 20 9
1 91 2 75 3 95 4 52 5 63 6 29 7 54 8 87 9 43 10 18 11 38 12 23 13 76 14 36 15 48 16 82 17 39 18 20 19 11 20 95
1 93 2 54 3 61 4 7 5 55 6 94 7 6 8 77 9 28 10 60 11 10 12 49 13 66 14 69 15 43 16 57 17 96 18 69 19 46 20 85
1 76 2 29 3 91 4 81 5 82 6 32 7 52 8 94 9 1 10 85 11 80 12 63 13 74 14 98 15 75 16 10 17 85 18 32 19 18 20 98
1 92 2 55 3 45 4 59 5 16 6 73 7 7 8 70 9 7 10 19 11 99 12 11 13 30 14 87 15 54 16 79 17 51 18 19 19 62 20 77
1 73 2 41 3 93 4 39 5 26 6 9 7 53 8 78 9 82 10 47 11 11 12 37 13 33 14 41 15 75 16 97 17 12 18 61 19 32 20 90
1 30 2 73 3 62 4 73 5 73 6 77 7 92 8 64 9 80 10 39 11 99 12 89 13 23 14 23 15 37 16 94 17 27 18 5 19 78 20 37
1 29 2 72 3 39 4 25 5 3 6 36 7 54 8 40 9 62 10 89 11 83 12 83 13 90 14 8 15 14 16 96 17 87 18 32 19 59 20 27
1 41 2 90 3 39 4 70 5 62 6 57 7 84 8 82 9 16 10 80 11 29 12 49 13 92 14 46 15 89 16 12 17 17 18 82 19 43 20 4
1 80 2 12 3 16 4 11 5 85 6 93 7 35 8 58 9 79 10 86 11 59 12 78 13 99 14 18 15 10 16 60 17 17 18 63 19 71 20 22
1 92 2 45 3 97 4 90 5 69 6 9 7 23 8 2 9 20 10 15 11 32 12 20 13 75 14 72 15 20 16 27 17 50 18 48 19 2 20 41
1 33 2 64 3 55 4 40 5 1 6 13 7 71 8 57 9 20 10 5 11 90 12 73 13 19 14 5 15 54 16 97 17 40 18 55 19 47 20 65
1 12 2 14 3 46 4 2 5 91 6 46 7 14 8 56 9 4 10 78 11 24 12 25 13 75 14 9 15 11 16 13 17 81 18 18 19 74 20 27
1 70 2 33 3 95 4 88 5 21 6 47 7 84 8 13 9 59 10 57 11 33 12 67 13 30 14 56 15 17 16 14 17 12 18 71 19 33 20 24
1 47 2 36 3 28 4 80 5 25 6 84 7 52 8 91 9 89 10 17 11 35 12 74 13 44 14 47 15 5 16 73 17 83 18 91 19 36 20 31
1 44 2 96 3 20 4 68 5 60 6 82 7 52 8 60 9 36 10 49 11 74 12 3 13 35 14 87 15 44 16 71 17 33 18 10 19 48 20 34
1 44 2 23 3 1 4 23 5 8 6 77 7 12 8 13 9 66 10 24 11 13 12 19 13 85 14 11 15 38 16 4 17 77 18 50 19 29 20 42
1 88 2 24 3 72 4 94 5 71 6 11 7 84 8 79 9 97 10 83 11 1 12 22 13 75 14 75 15 21 16 19 17 3 18 7 19 19 20 59
1 70 2 59 3 46 4 31 5 99 6 15 7 39 8 13 9 41 10 2 11 21 12 13 13 93 14 38 15 6 16 23 17 46 18 66 19 85 20 64
1 93 2 1 3 40 4 71 5 65 6 78 7 21 8 77 9 28 10 4 11 58 12 91 13 93 14 71 15 42 16 18 17 96 18 32 19 68 20 73
1 53 2 89 3 29 4 59 5 32 6 79 7 87 8 9 9 51 10 46 11 5 12 24 13 11 14 98 15 5 16 20 17 54 18 10 19 53 20 78
1 19 2 84 3 15 4 4 5 51 6 74 7 60 8 55 9 27 10 81 11 13 12 95 13 26 14 82 15 61 16 46 17 93 18 58 19 74 20 54
1 99 2 26 3 12 4 14 5 96 6 64 7 79 8 17 9 20 10 71 11 25 12 60 13 6 14 70 15 51 16 21 17 89 18 54 19 21 20 65
1 23 2 84 3 91 4 59 5 36 6 15 7 22 8 6 9 1 10 30 11 6 12 36 13 86 14 63 15 91 16 36 17 67 18 30 19 74 20 75
1 56 2 18 3 52 4 6 5 7 6 96 7 35 8 54 9 48 10 2 11 5 12 89 13 24 14 1 15 36 16 37 17 63 18 36 19 17 20 28
Reldue
-1	1675	-1	5
-1	2374	-1	8
-1	2538	-1	7
-1	2158	-1	1
-1	2839	-1	1
-1	3502	-1	2
-1	1883	-1	1
-1	1244	-1	9
-1	3593	-1	1
-1	1705	-1	8
-1	3985	-1	4
-1	3972	-1	2
-1	2331	-1	2
-1	3033	-1	1
-1	4191	-1	7
-1	1236	-1	6
-1	1559	-1	5
-1	1355	-1	5
-1	1498	-1	9
-1	2435	-1	5
-1	3071	-1	7
-1	3717	-1	3
-1	1326	-1	9
-1	1465	-1	9
-1	3927	-1	1
-1	3188	-1	3
-1	1724	-1	2
-1	1238	-1	3
-1	3874	-1	5
-1	2618	-1	2
-1	2360	-1	8
-1	3162	-1	2
-1	2727	-1	8
-1	2377	-1	5
-1	1778	-1	8
-1	1396	-1	6
-1	2472	-1	7
-1	2205	-1	10
-1	3807	-1	1
-1	4247	-1	3
-1	2148	-1	5
-1	1403	-1	2
-1	1254	-1	4
-1	2676	-1	7
-1	2793	-1	9
-1	4273	-1	9
-1	2411	-1	3
-1	1558	-1	3
-1	3576	-1	1
-1	3416	-1	4
-1	1578	-1	7
-1	1859	-1	8
-1	1486	-1	10
-1	2175	-1	10
-1	2438	-1	1
-1	1592	-1	6
-1	3631	-1	3
-1	1400	-1	9
-1	2566	-1	3
-1	1315	-1	4
-1	1616	-1	7
-1	1876	-1	2
-1	2628	-1	6
-1	2382	-1	2
-1	2692	-1	7
-1	3898	-1	2
-1	2554	-1	9
-1	1497	-1	2
-1	3336	-1	9
-1	1754	-1	10
-1	3739	-1	5
-1	1575	-1	2
-1	3021	-1	10
-1	2511	-1	8
-1	3563	-1	10
-1	3024	-1	6
-1	3583	-1	1
-1	1347	-1	1
-1	1942	-1	9
-1	3487	-1	10
-1	2497	-1	8
-1	3862	-1	9
-1	1992	-1	4
-1	3086	-1	3
-1	2207	-1	6
-1	2717	-1	6
-1	2166	-1	1
-1	2426	-1	9
-1	2236	-1	5
-1	3980	-1	6
-1	2609	-1	7
-1	2329	-1	2
-1	2448	-1	5
-1	1287	-1	2
-1	1553	-1	2
-1	2716	-1	10
-1	3346	-1	3
-1	1966	-1	8
-1	3391	-1	10
-1	1130	-1	6
