50 20
1 93 2 72 3 95 4 38 5 79 6 26 7 46 8 68 9 90 10 17 11 79 12 30 13 88 14 19 15 58 16 14 17 95 18 12 19 87 20 42
1 92 2 17 3 13 4 27 5 68 6 15 7 55 8 42 9 92 10 7 11 49 12 25 13 89 14 72 15 40 16 85 17 79 18 83 19 72 20 25
1 84 2 61 3 58 4 60 5 78 6 92 7 91 8 76 9 18 10 46 11 93 12 28 13 10 14 35 15 79 16 62 17 30 18 16 19 59 20 70
1 64 2 53 3 61 4 26 5 62 6 11 7 1 8 57 9 15 10 99 11 7 12 63 13 26 14 52 15 57 16 15 17 96 18 13 19 44 20 76
1 55 2 1 3 57 4 50 5 79 6 7 7 10 8 34 9 19 10 88 11 59 12 94 13 89 14 48 15 25 16 85 17 93 18 14 19 35 20 3
1 7 2 95 3 92 4 32 5 18 6 21 7 18 8 76 9 9 10 44 11 40 12 13 13 31 14 28 15 60 16 21 17 53 18 8 19 98 20 89
1 89 2 82 3 93 4 45 5 9 6 60 7 11 8 59 9 58 10 23 11 25 12 86 13 18 14 15 15 62 16 43 17 52 18 52 19 4 20 7
1 68 2 71 3 24 4 17 5 99 6 63 7 83 8 76 9 38 10 86 11 96 12 10 13 49 14 95 15 46 16 10 17 39 18 2 19 12 20 29
1 90 2 31 3 51 4 88 5 24 6 97 7 33 8 18 9 36 10 51 11 63 12 3 13 4 14 4 15 99 16 39 17 30 18 51 19 32 20 31
1 6 2 88 3 22 4 46 5 3 6 60 7 19 8 2 9 77 10 42 11 57 12 55 13 68 14 52 15 23 16 13 17 44 18 81 19 76 20 14
1 2 2 84 3 32 4 61 5 60 6 14 7 72 8 76 9 71 10 88 11 95 12 34 13 78 14 43 15 24 16 21 17 17 18 54 19 90 20 43
1 98 2 24 3 44 4 28 5 51 6 81 7 30 8 39 9 59 10 59 11 74 12 19 13 6 14 10 15 86 16 49 17 45 18 24 19 56 20 67
1 9 2 81 3 52 4 45 5 10 6 49 7 94 8 68 9 90 10 56 11 96 12 21 13 25 14 29 15 80 16 1 17 52 18 23 19 78 20 90
1 1 2 65 3 32 4 37 5 31 6 37 7 69 8 14 9 74 10 9 11 80 12 91 13 72 14 89 15 44 16 26 17 96 18 33 19 5 20 90
1 74 2 1 3 37 4 20 5 65 6 54 7 23 8 36 9 37 10 7 11 33 12 25 13 7 14 71 15 39 16 31 17 52 18 81 19 53 20 43
1 9 2 39 3 81 4 47 5 32 6 64 7 50 8 84 9 99 10 2 11 7 12 71 13 44 14 76 15 39 16 66 17 75 18 78 19 74 20 17
1 82 2 95 3 51 4 61 5 20 6 25 7 16 8 43 9 22 10 71 11 98 12 18 13 51 14 38 15 6 16 27 17 24 18 29 19 56 20 14
1 23 2 40 3 81 4 11 5 11 6 89 7 93 8 51 9 27 10 2 11 86 12 18 13 76 14 65 15 99 16 82 17 36 18 20 19 31 20 75
1 51 2 85 3 94 4 91 5 98 6 56 7 74 8 43 9 10 10 47 11 83 12 10 13 20 14 81 15 39 16 10 17 96 18 41 19 73 20 65
1 59 2 78 3 39 4 61 5 23 6 84 7 98 8 65 9 23 10 95 11 6 12 72 13 24 14 17 15 47 16 78 17 24 18 15 19 14 20 34
1 26 2 21 3 78 4 12 5 45 6 5 7 34 8 23 9 35 10 38 11 45 12 16 13 85 14 3 15 24 16 30 17 68 18 17 19 71 20 97
1 36 2 58 3 27 4 52 5 47 6 27 7 89 8 54 9 93 10 78 11 95 12 36 13 2 14 7 15 67 16 88 17 22 18 9 19 47 20 64
1 62 2 6 3 89 4 3 5 83 6 6 7 73 8 43 9 58 10 51 11 96 12 96 13 63 14 80 15 20 16 90 17 4 18 69 19 90 20 39
1 1 2 72 3 27 4 17 5 29 6 36 7 48 8 3 9 65 10 93 11 55 12 6 13 41 14 23 15 55 16 9 17 48 18 16 19 67 20 68
1 43 2 44 3 58 4 53 5 48 6 98 7 33 8 38 9 37 10 77 11 5 12 69 13 89 14 43 15 49 16 18 17 47 18 10 19 46 20 51
1 3 2 46 3 55 4 5 5 65 6 41 7 11 8 38 9 19 10 3 11 70 12 75 13 29 14 30 15 5 16 93 17 69 18 64 19 99 20 5
1 30 2 35 3 3 4 70 5 99 6 19 7 15 8 13 9 58 10 4 11 40 12 67 13 29 14 14 15 30 16 41 17 83 18 90 19 81 20 86
1 75 2 74 3 52 4 86 5 5 6 46 7 16 8 92 9 20 10 1 11 97 12 77 13 65 14 74 15 53 16 82 17 47 18 1 19 99 20 89
1 29 2 32 3 86 4 40 5 59 6 4 7 56 8 62 9 13 10 71 11 93 12 80 13 53 14 71 15 24 16 15 17 91 18 79 19 89 20 15
1 85 2 52 3 76 4 85 5 60 6 12 7 93 8 47 9 20 10 77 11 56 12 82 13 34 14 77 15 65 16 46 17 93 18 58 19 8 20 4
1 58 2 81 3 45 4 68 5 35 6 19 7 78 8 35 9 75 10 57 11 4 12 43 13 91 14 43 15 57 16 71 17 81 18 51 19 74 20 41
1 27 2 28 3 60 4 88 5 39 6 11 7 10 8 25 9 87 10 1 11 73 12 77 13 20 14 24 15 67 16 70 17 46 18 51 19 91 20 60
1 2 2 9 3 54 4 62 5 80 6 57 7 1 8 55 9 70 10 62 11 83 12 61 13 9 14 38 15 19 16 63 17 81 18 92 19 42 20 58
1 35 2 21 3 43 4 98 5 80 6 82 7 55 8 92 9 99 10 26 11 87 12 31 13 62 14 84 15 63 16 97 17 38 18 7 19 5 20 35
1 72 2 94 3 85 4 55 5 76 6 12 7 65 8 93 9 71 10 20 11 39 12 31 13 15 14 22 15 80 16 14 17 24 18 81 19 84 20 49
1 18 2 46 3 30 4 20 5 56 6 1 7 59 8 45 9 32 10 87 11 27 12 7 13 72 14 34 15 84 16 39 17 11 18 75 19 29 20 62
1 26 2 96 3 3 4 20 5 34 6 85 7 33 8 84 9 60 10 89 11 78 12 78 13 74 14 98 15 9 16 76 17 31 18 38 19 74 20 72
1 28 2 82 3 97 4 48 5 86 6 21 7 78 8 96 9 87 10 4 11 24 12 95 13 34 14 55 15 73 16 80 17 87 18 44 19 43 20 38
1 9 2 42 3 76 4 92 5 6 6 62 7 12 8 13 9 18 10 43 11 49 12 14 13 28 14 71 15 22 16 58 17 75 18 45 19 92 20 94
1 27 2 90 3 79 4 82 5 63 6 69 7 75 8 74 9 73 10 40 11 1 12 74 13 61 14 26 15 23 16 37 17 48 18 18 19 37 20 71
1 86 2 50 3 84 4 23 5 97 6 46 7 49 8 83 9 54 10 92 11 68 12 58 13 85 14 35 15 55 16 22 17 55 18 62 19 87 20 86
1 40 2 29 3 82 4 68 5 60 6 33 7 29 8 9 9 19 10 52 11 25 12 47 13 50 14 67 15 22 16 71 17 58 18 9 19 76 20 23
1 41 2 47 3 93 4 42 5 3 6 47 7 79 8 25 9 3 10 29 11 17 12 86 13 8 14 11 15 35 16 83 17 38 18 57 19 48 20 82
1 80 2 18 3 84 4 17 5 52 6 64 7 11 8 82 9 41 10 65 11 95 12 50 13 25 14 50 15 98 16 92 17 81 18 75 19 96 20 34
1 92 2 63 3 29 4 89 5 66 6 56 7 68 8 56 9 95 10 38 11 26 12 54 13 52 14 75 15 40 16 9 17 57 18 85 19 54 20 64
1 46 2 64 3 66 4 41 5 92 6 87 7 7 8 87 9 43 10 44 11 78 12 67 13 37 14 80 15 59 16 6 17 35 18 43 19 13 20 43
1 86 2 28 3 52 4 55 5 20 6 83 7 37 8 46 9 66 10 84 11 67 12 86 13 68 14 92 15 84 16 91 17 88 18 5 19 61 20 86
1 63 2 72 3 91 4 85 5 17 6 88 7 91 8 87 9 70 10 56 11 7 12 22 13 36 14 39 15 56 16 67 17 70 18 51 19 45 20 1
1 82 2 24 3 95 4 36 5 69 6 45 7 85 8 23 9 46 10 43 11 76 12 26 13 78 14 5 15 32 16 33 17 92 18 26 19 93 20 21
1 72 2 1 3 74 4 79 5 7 6 38 7 85 8 44 9 99 10 19 11 87 12 99 13 22 14 58 15 92 16 16 17 28 18 65 19 29 20 72
Reldue
-1	2287	-1	10
-1	2205	-1	10
-1	3355	-1	3
-1	1650	-1	5
-1	2461	-1	6
-1	3371	-1	4
-1	2822	-1	9
-1	4041	-1	10
-1	2460	-1	1
-1	1554	-1	3
-1	3448	-1	3
-1	1627	-1	3
-1	2497	-1	8
-1	1437	-1	1
-1	3106	-1	6
-1	1497	-1	5
-1	1084	-1	5
-1	1834	-1	5
-1	2928	-1	1
-1	3334	-1	8
-1	2153	-1	6
-1	2146	-1	5
-1	3250	-1	10
-1	2076	-1	3
-1	3712	-1	10
-1	1693	-1	1
-1	2074	-1	2
-1	3331	-1	9
-1	2558	-1	9
-1	1551	-1	3
-1	4182	-1	8
-1	1131	-1	1
-1	1649	-1	3
-1	2897	-1	10
-1	3504	-1	6
-1	2186	-1	6
-1	2360	-1	8
-1	2793	-1	4
-1	2881	-1	3
-1	1323	-1	6
-1	2518	-1	7
-1	1702	-1	9
-1	3175	-1	9
-1	3833	-1	8
-1	2371	-1	7
-1	2636	-1	5
-1	3248	-1	10
-1	4432	-1	10
-1	3974	-1	8
-1	2337	-1	2
