50 20
1 72 2 44 3 88 4 26 5 70 6 62 7 54 8 80 9 20 10 8 11 6 12 62 13 49 14 11 15 90 16 12 17 60 18 92 19 1 20 26
1 25 2 46 3 40 4 63 5 11 6 20 7 36 8 58 9 88 10 93 11 36 12 84 13 78 14 87 15 10 16 81 17 34 18 64 19 63 20 73
1 75 2 76 3 77 4 73 5 74 6 8 7 99 8 30 9 77 10 69 11 79 12 59 13 51 14 63 15 58 16 62 17 8 18 42 19 88 20 35
1 7 2 42 3 83 4 41 5 77 6 87 7 76 8 94 9 59 10 73 11 46 12 43 13 55 14 19 15 65 16 50 17 61 18 57 19 27 20 25
1 47 2 36 3 36 4 56 5 3 6 39 7 69 8 84 9 68 10 17 11 90 12 43 13 12 14 82 15 12 16 75 17 72 18 34 19 2 20 25
1 75 2 66 3 9 4 52 5 97 6 75 7 94 8 89 9 90 10 91 11 17 12 24 13 23 14 34 15 53 16 88 17 11 18 12 19 95 20 92
1 47 2 70 3 84 4 12 5 93 6 52 7 60 8 66 9 54 10 55 11 4 12 85 13 40 14 44 15 38 16 11 17 96 18 40 19 69 20 69
1 9 2 25 3 19 4 37 5 86 6 17 7 84 8 74 9 85 10 66 11 16 12 48 13 80 14 95 15 52 16 27 17 49 18 73 19 67 20 43
1 4 2 30 3 69 4 82 5 32 6 57 7 11 8 26 9 45 10 88 11 51 12 64 13 27 14 11 15 12 16 42 17 35 18 81 19 61 20 32
1 38 2 50 3 31 4 12 5 7 6 8 7 1 8 8 9 90 10 12 11 34 12 36 13 17 14 64 15 38 16 54 17 95 18 19 19 84 20 3
1 87 2 45 3 68 4 50 5 74 6 6 7 36 8 19 9 46 10 69 11 17 12 58 13 69 14 83 15 13 16 14 17 44 18 94 19 83 20 58
1 79 2 52 3 7 4 19 5 90 6 6 7 16 8 5 9 62 10 80 11 17 12 64 13 79 14 25 15 64 16 66 17 78 18 90 19 97 20 23
1 36 2 88 3 9 4 38 5 41 6 80 7 62 8 8 9 51 10 33 11 25 12 95 13 83 14 36 15 92 16 22 17 87 18 4 19 37 20 52
1 91 2 21 3 25 4 85 5 65 6 6 7 46 8 74 9 81 10 30 11 62 12 68 13 65 14 26 15 64 16 9 17 20 18 96 19 99 20 40
1 83 2 29 3 39 4 16 5 78 6 79 7 91 8 71 9 86 10 13 11 33 12 17 13 48 14 23 15 17 16 35 17 80 18 65 19 76 20 14
1 58 2 57 3 44 4 82 5 24 6 59 7 33 8 48 9 4 10 10 11 82 12 27 13 60 14 76 15 65 16 39 17 95 18 66 19 58 20 65
1 7 2 54 3 35 4 54 5 63 6 52 7 83 8 76 9 24 10 88 11 12 12 46 13 24 14 18 15 71 16 2 17 6 18 4 19 13 20 81
1 5 2 47 3 48 4 68 5 24 6 2 7 87 8 19 9 6 10 27 11 35 12 63 13 1 14 82 15 32 16 46 17 75 18 10 19 72 20 90
1 75 2 17 3 20 4 71 5 1 6 37 7 18 8 29 9 63 10 45 11 84 12 81 13 58 14 31 15 22 16 80 17 43 18 34 19 99 20 20
1 29 2 81 3 53 4 50 5 29 6 5 7 93 8 57 9 72 10 71 11 86 12 88 13 19 14 63 15 81 16 8 17 45 18 3 19 15 20 83
1 71 2 12 3 97 4 98 5 12 6 88 7 51 8 75 9 51 10 61 11 7 12 63 13 74 14 63 15 42 16 8 17 11 18 15 19 59 20 9
1 91 2 75 3 95 4 52 5 63 6 29 7 54 8 87 9 43 10 18 11 38 12 23 13 76 14 36 15 48 16 82 17 39 18 20 19 11 20 95
1 93 2 54 3 61 4 7 5 55 6 94 7 6 8 77 9 28 10 60 11 10 12 49 13 66 14 69 15 43 16 57 17 96 18 69 19 46 20 85
1 76 2 29 3 91 4 81 5 82 6 32 7 52 8 94 9 1 10 85 11 80 12 63 13 74 14 98 15 75 16 10 17 85 18 32 19 18 20 98
1 92 2 55 3 45 4 59 5 16 6 73 7 7 8 70 9 7 10 19 11 99 12 11 13 30 14 87 15 54 16 79 17 51 18 19 19 62 20 77
1 73 2 41 3 93 4 39 5 26 6 9 7 53 8 78 9 82 10 47 11 11 12 37 13 33 14 41 15 75 16 97 17 12 18 61 19 32 20 90
1 30 2 73 3 62 4 73 5 73 6 77 7 92 8 64 9 80 10 39 11 99 12 89 13 23 14 23 15 37 16 94 17 27 18 5 19 78 20 37
1 29 2 72 3 39 4 25 5 3 6 36 7 54 8 40 9 62 10 89 11 83 12 83 13 90 14 8 15 14 16 96 17 87 18 32 19 59 20 27
1 41 2 90 3 39 4 70 5 62 6 57 7 84 8 82 9 16 10 80 11 29 12 49 13 92 14 46 15 89 16 12 17 17 18 82 19 43 20 4
1 80 2 12 3 16 4 11 5 85 6 93 7 35 8 58 9 79 10 86 11 59 12 78 13 99 14 18 15 10 16 60 17 17 18 63 19 71 20 22
1 92 2 45 3 97 4 90 5 69 6 9 7 23 8 2 9 20 10 15 11 32 12 20 13 75 14 72 15 20 16 27 17 50 18 48 19 2 20 41
1 33 2 64 3 55 4 40 5 1 6 13 7 71 8 57 9 20 10 5 11 90 12 73 13 19 14 5 15 54 16 97 17 40 18 55 19 47 20 65
1 12 2 14 3 46 4 2 5 91 6 46 7 14 8 56 9 4 10 78 11 24 12 25 13 75 14 9 15 11 16 13 17 81 18 18 19 74 20 27
1 70 2 33 3 95 4 88 5 21 6 47 7 84 8 13 9 59 10 57 11 33 12 67 13 30 14 56 15 17 16 14 17 12 18 71 19 33 20 24
1 47 2 36 3 28 4 80 5 25 6 84 7 52 8 91 9 89 10 17 11 35 12 74 13 44 14 47 15 5 16 73 17 83 18 91 19 36 20 31
1 44 2 96 3 20 4 68 5 60 6 82 7 52 8 60 9 36 10 49 11 74 12 3 13 35 14 87 15 44 16 71 17 33 18 10 19 48 20 34
1 44 2 23 3 1 4 23 5 8 6 77 7 12 8 13 9 66 10 24 11 13 12 19 13 85 14 11 15 38 16 4 17 77 18 50 19 29 20 42
1 88 2 24 3 72 4 94 5 71 6 11 7 84 8 79 9 97 10 83 11 1 12 22 13 75 14 75 15 21 16 19 17 3 18 7 19 19 20 59
1 70 2 59 3 46 4 31 5 99 6 15 7 39 8 13 9 41 10 2 11 21 12 13 13 93 14 38 15 6 16 23 17 46 18 66 19 85 20 64
1 93 2 1 3 40 4 71 5 65 6 78 7 21 8 77 9 28 10 4 11 58 12 91 13 93 14 71 15 42 16 18 17 96 18 32 19 68 20 73
1 53 2 89 3 29 4 59 5 32 6 79 7 87 8 9 9 51 10 46 11 5 12 24 13 11 14 98 15 5 16 20 17 54 18 10 19 53 20 78
1 19 2 84 3 15 4 4 5 51 6 74 7 60 8 55 9 27 10 81 11 13 12 95 13 26 14 82 15 61 16 46 17 93 18 58 19 74 20 54
1 99 2 26 3 12 4 14 5 96 6 64 7 79 8 17 9 20 10 71 11 25 12 60 13 6 14 70 15 51 16 21 17 89 18 54 19 21 20 65
1 23 2 84 3 91 4 59 5 36 6 15 7 22 8 6 9 1 10 30 11 6 12 36 13 86 14 63 15 91 16 36 17 67 18 30 19 74 20 75
1 56 2 18 3 52 4 6 5 7 6 96 7 35 8 54 9 48 10 2 11 5 12 89 13 24 14 1 15 36 16 37 17 63 18 36 19 17 20 28
1 38 2 47 3 54 4 78 5 51 6 60 7 53 8 4 9 83 10 10 11 82 12 19 13 38 14 1 15 4 16 82 17 83 18 8 19 20 20 72
1 92 2 35 3 90 4 11 5 63 6 16 7 81 8 2 9 85 10 64 11 9 12 51 13 36 14 40 15 13 16 44 17 19 18 81 19 44 20 41
1 79 2 66 3 89 4 27 5 13 6 85 7 16 8 89 9 91 10 7 11 68 12 27 13 19 14 15 15 14 16 24 17 85 18 47 19 57 20 18
1 38 2 76 3 85 4 15 5 76 6 78 7 61 8 50 9 22 10 77 11 17 12 54 13 46 14 62 15 53 16 92 17 83 18 4 19 89 20 27
1 32 2 45 3 22 4 11 5 14 6 31 7 62 8 62 9 52 10 87 11 75 12 84 13 39 14 23 15 26 16 29 17 96 18 3 19 86 20 30
Reldue
-1	1487	-1	7
-1	2502	-1	8
-1	1795	-1	10
-1	2420	-1	10
-1	2669	-1	1
-1	2025	-1	6
-1	3627	-1	3
-1	1224	-1	9
-1	2030	-1	3
-1	1022	-1	4
-1	1406	-1	7
-1	1756	-1	2
-1	2446	-1	6
-1	2973	-1	2
-1	3813	-1	7
-1	3970	-1	2
-1	2037	-1	9
-1	1283	-1	2
-1	2885	-1	9
-1	1821	-1	10
-1	3437	-1	5
-1	2083	-1	2
-1	4051	-1	10
-1	3398	-1	8
-1	3497	-1	10
-1	3222	-1	6
-1	3917	-1	1
-1	1231	-1	1
-1	1676	-1	9
-1	3625	-1	10
-1	2058	-1	8
-1	2971	-1	9
-1	1395	-1	4
-1	2630	-1	3
-1	2240	-1	6
-1	3219	-1	6
-1	1579	-1	1
-1	3383	-1	9
-1	2106	-1	5
-1	4174	-1	6
-1	2313	-1	7
-1	3788	-1	2
-1	2340	-1	5
-1	1377	-1	2
-1	984	-1	2
-1	2701	-1	10
-1	2862	-1	3
-1	1917	-1	8
-1	4025	-1	10
-1	1446	-1	6
