60 20
1 79 2 52 3 7 4 19 5 90 6 6 7 16 8 5 9 62 10 80 11 17 12 64 13 79 14 25 15 64 16 66 17 78 18 90 19 97 20 23
1 36 2 88 3 9 4 38 5 41 6 80 7 62 8 8 9 51 10 33 11 25 12 95 13 83 14 36 15 92 16 22 17 87 18 4 19 37 20 52
1 91 2 21 3 25 4 85 5 65 6 6 7 46 8 74 9 81 10 30 11 62 12 68 13 65 14 26 15 64 16 9 17 20 18 96 19 99 20 40
1 83 2 29 3 39 4 16 5 78 6 79 7 91 8 71 9 86 10 13 11 33 12 17 13 48 14 23 15 17 16 35 17 80 18 65 19 76 20 14
1 58 2 57 3 44 4 82 5 24 6 59 7 33 8 48 9 4 10 10 11 82 12 27 13 60 14 76 15 65 16 39 17 95 18 66 19 58 20 65
1 7 2 54 3 35 4 54 5 63 6 52 7 83 8 76 9 24 10 88 11 12 12 46 13 24 14 18 15 71 16 2 17 6 18 4 19 13 20 81
1 5 2 47 3 48 4 68 5 24 6 2 7 87 8 19 9 6 10 27 11 35 12 63 13 1 14 82 15 32 16 46 17 75 18 10 19 72 20 90
1 75 2 17 3 20 4 71 5 1 6 37 7 18 8 29 9 63 10 45 11 84 12 81 13 58 14 31 15 22 16 80 17 43 18 34 19 99 20 20
1 29 2 81 3 53 4 50 5 29 6 5 7 93 8 57 9 72 10 71 11 86 12 88 13 19 14 63 15 81 16 8 17 45 18 3 19 15 20 83
1 71 2 12 3 97 4 98 5 12 6 88 7 51 8 75 9 51 10 61 11 7 12 63 13 74 14 63 15 42 16 8 17 11 18 15 19 59 20 9
1 91 2 75 3 95 4 52 5 63 6 29 7 54 8 87 9 43 10 18 11 38 12 23 13 76 14 36 15 48 16 82 17 39 18 20 19 11 20 95
1 93 2 54 3 61 4 7 5 55 6 94 7 6 8 77 9 28 10 60 11 10 12 49 13 66 14 69 15 43 16 57 17 96 18 69 19 46 20 85
1 76 2 29 3 91 4 81 5 82 6 32 7 52 8 94 9 1 10 85 11 80 12 63 13 74 14 98 15 75 16 10 17 85 18 32 19 18 20 98
1 92 2 55 3 45 4 59 5 16 6 73 7 7 8 70 9 7 10 19 11 99 12 11 13 30 14 87 15 54 16 79 17 51 18 19 19 62 20 77
1 73 2 41 3 93 4 39 5 26 6 9 7 53 8 78 9 82 10 47 11 11 12 37 13 33 14 41 15 75 16 97 17 12 18 61 19 32 20 90
1 30 2 73 3 62 4 73 5 73 6 77 7 92 8 64 9 80 10 39 11 99 12 89 13 23 14 23 15 37 16 94 17 27 18 5 19 78 20 37
1 29 2 72 3 39 4 25 5 3 6 36 7 54 8 40 9 62 10 89 11 83 12 83 13 90 14 8 15 14 16 96 17 87 18 32 19 59 20 27
1 41 2 90 3 39 4 70 5 62 6 57 7 84 8 82 9 16 10 80 11 29 12 49 13 92 14 46 15 89 16 12 17 17 18 82 19 43 20 4
1 80 2 12 3 16 4 11 5 85 6 93 7 35 8 58 9 79 10 86 11 59 12 78 13 99 14 18 15 10 16 60 17 17 18 63 19 71 20 22
1 92 2 45 3 97 4 90 5 69 6 9 7 23 8 2 9 20 10 15 11 32 12 20 13 75 14 72 15 20 16 27 17 50 18 48 19 2 20 41
1 33 2 64 3 55 4 40 5 1 6 13 7 71 8 57 9 20 10 5 11 90 12 73 13 19 14 5 15 54 16 97 17 40 18 55 19 47 20 65
1 12 2 14 3 46 4 2 5 91 6 46 7 14 8 56 9 4 10 78 11 24 12 25 13 75 14 9 15 11 16 13 17 81 18 18 19 74 20 27
1 70 2 33 3 95 4 88 5 21 6 47 7 84 8 13 9 59 10 57 11 33 12 67 13 30 14 56 15 17 16 14 17 12 18 71 19 33 20 24
1 47 2 36 3 28 4 80 5 25 6 84 7 52 8 91 9 89 10 17 11 35 12 74 13 44 14 47 15 5 16 73 17 83 18 91 19 36 20 31
1 44 2 96 3 20 4 68 5 60 6 82 7 52 8 60 9 36 10 49 11 74 12 3 13 35 14 87 15 44 16 71 17 33 18 10 19 48 20 34
1 44 2 23 3 1 4 23 5 8 6 77 7 12 8 13 9 66 10 24 11 13 12 19 13 85 14 11 15 38 16 4 17 77 18 50 19 29 20 42
1 88 2 24 3 72 4 94 5 71 6 11 7 84 8 79 9 97 10 83 11 1 12 22 13 75 14 75 15 21 16 19 17 3 18 7 19 19 20 59
1 70 2 59 3 46 4 31 5 99 6 15 7 39 8 13 9 41 10 2 11 21 12 13 13 93 14 38 15 6 16 23 17 46 18 66 19 85 20 64
1 93 2 1 3 40 4 71 5 65 6 78 7 21 8 77 9 28 10 4 11 58 12 91 13 93 14 71 15 42 16 18 17 96 18 32 19 68 20 73
1 53 2 89 3 29 4 59 5 32 6 79 7 87 8 9 9 51 10 46 11 5 12 24 13 11 14 98 15 5 16 20 17 54 18 10 19 53 20 78
1 19 2 84 3 15 4 4 5 51 6 74 7 60 8 55 9 27 10 81 11 13 12 95 13 26 14 82 15 61 16 46 17 93 18 58 19 74 20 54
1 99 2 26 3 12 4 14 5 96 6 64 7 79 8 17 9 20 10 71 11 25 12 60 13 6 14 70 15 51 16 21 17 89 18 54 19 21 20 65
1 23 2 84 3 91 4 59 5 36 6 15 7 22 8 6 9 1 10 30 11 6 12 36 13 86 14 63 15 91 16 36 17 67 18 30 19 74 20 75
1 56 2 18 3 52 4 6 5 7 6 96 7 35 8 54 9 48 10 2 11 5 12 89 13 24 14 1 15 36 16 37 17 63 18 36 19 17 20 28
1 38 2 47 3 54 4 78 5 51 6 60 7 53 8 4 9 83 10 10 11 82 12 19 13 38 14 1 15 4 16 82 17 83 18 8 19 20 20 72
1 92 2 35 3 90 4 11 5 63 6 16 7 81 8 2 9 85 10 64 11 9 12 51 13 36 14 40 15 13 16 44 17 19 18 81 19 44 20 41
1 79 2 66 3 89 4 27 5 13 6 85 7 16 8 89 9 91 10 7 11 68 12 27 13 19 14 15 15 14 16 24 17 85 18 47 19 57 20 18
1 38 2 76 3 85 4 15 5 76 6 78 7 61 8 50 9 22 10 77 11 17 12 54 13 46 14 62 15 53 16 92 17 83 18 4 19 89 20 27
1 32 2 45 3 22 4 11 5 14 6 31 7 62 8 62 9 52 10 87 11 75 12 84 13 39 14 23 15 26 16 29 17 96 18 3 19 86 20 30
1 20 2 66 3 43 4 73 5 17 6 98 7 41 8 96 9 65 10 7 11 24 12 50 13 77 14 22 15 6 16 80 17 45 18 29 19 16 20 31
1 12 2 61 3 24 4 16 5 50 6 56 7 59 8 12 9 94 10 62 11 92 12 16 13 50 14 88 15 18 16 12 17 70 18 80 19 26 20 94
1 85 2 45 3 31 4 11 5 86 6 95 7 57 8 78 9 82 10 93 11 71 12 58 13 78 14 5 15 7 16 2 17 19 18 87 19 81 20 95
1 48 2 76 3 76 4 85 5 31 6 37 7 61 8 27 9 37 10 55 11 73 12 53 13 47 14 2 15 79 16 81 17 47 18 46 19 91 20 51
1 53 2 68 3 84 4 19 5 48 6 49 7 16 8 12 9 13 10 11 11 68 12 94 13 71 14 21 15 35 16 71 17 88 18 98 19 20 20 51
1 77 2 45 3 72 4 88 5 24 6 72 7 1 8 44 9 13 10 50 11 10 12 14 13 60 14 92 15 38 16 79 17 4 18 75 19 89 20 1
1 74 2 86 3 87 4 46 5 20 6 34 7 94 8 43 9 53 10 84 11 59 12 53 13 95 14 24 15 87 16 53 17 83 18 40 19 44 20 88
1 57 2 48 3 28 4 28 5 22 6 67 7 63 8 76 9 21 10 78 11 22 12 2 13 90 14 66 15 66 16 18 17 72 18 5 19 65 20 10
1 84 2 70 3 67 4 47 5 75 6 82 7 36 8 50 9 17 10 54 11 63 12 46 13 58 14 82 15 73 16 54 17 63 18 92 19 27 20 3
1 24 2 27 3 2 4 42 5 23 6 92 7 96 8 17 9 21 10 23 11 43 12 20 13 27 14 91 15 98 16 8 17 66 18 5 19 71 20 38
1 13 2 2 3 66 4 57 5 5 6 84 7 78 8 77 9 80 10 85 11 23 12 45 13 70 14 63 15 45 16 97 17 75 18 79 19 48 20 64
1 66 2 13 3 51 4 33 5 29 6 67 7 16 8 75 9 59 10 76 11 90 12 33 13 89 14 74 15 57 16 29 17 77 18 33 19 82 20 76
1 27 2 92 3 58 4 58 5 73 6 63 7 63 8 44 9 79 10 66 11 4 12 10 13 82 14 95 15 12 16 24 17 25 18 86 19 75 20 85
1 7 2 86 3 86 4 35 5 2 6 29 7 62 8 93 9 94 10 32 11 50 12 86 13 97 14 82 15 70 16 74 17 70 18 93 19 13 20 98
1 77 2 82 3 86 4 35 5 38 6 83 7 62 8 19 9 97 10 2 11 8 12 85 13 1 14 26 15 46 16 14 17 81 18 72 19 48 20 99
1 84 2 31 3 78 4 71 5 37 6 39 7 13 8 81 9 77 10 17 11 96 12 18 13 43 14 14 15 67 16 64 17 72 18 78 19 13 20 61
1 99 2 8 3 21 4 76 5 19 6 99 7 89 8 19 9 58 10 79 11 73 12 13 13 39 14 71 15 28 16 48 17 42 18 76 19 94 20 42
1 84 2 71 3 20 4 19 5 34 6 32 7 46 8 87 9 1 10 28 11 15 12 94 13 90 14 96 15 95 16 18 17 4 18 77 19 26 20 26
1 20 2 22 3 35 4 94 5 90 6 99 7 38 8 34 9 53 10 34 11 70 12 6 13 25 14 20 15 75 16 77 17 58 18 85 19 38 20 94
1 67 2 99 3 11 4 98 5 94 6 23 7 33 8 95 9 56 10 16 11 39 12 40 13 62 14 55 15 26 16 44 17 95 18 55 19 87 20 93
1 63 2 59 3 84 4 64 5 49 6 44 7 95 8 84 9 30 10 2 11 32 12 51 13 9 14 13 15 39 16 76 17 56 18 37 19 3 20 91
Reldue
-1	1808	-1	8
-1	3362	-1	6
-1	2775	-1	4
-1	2835	-1	8
-1	1487	-1	4
-1	1316	-1	7
-1	1685	-1	4
-1	3065	-1	7
-1	1673	-1	7
-1	3333	-1	5
-1	1279	-1	9
-1	1396	-1	7
-1	4043	-1	7
-1	2838	-1	8
-1	3125	-1	8
-1	2520	-1	10
-1	1598	-1	7
-1	3564	-1	9
-1	2692	-1	8
-1	1592	-1	10
-1	2510	-1	2
-1	1708	-1	7
-1	2512	-1	10
-1	3813	-1	2
-1	2004	-1	3
-1	2034	-1	7
-1	1253	-1	9
-1	3436	-1	10
-1	1966	-1	10
-1	2440	-1	5
-1	3279	-1	5
-1	1427	-1	3
-1	3049	-1	8
-1	1251	-1	9
-1	3016	-1	6
-1	2365	-1	5
-1	2043	-1	3
-1	2490	-1	9
-1	1641	-1	6
-1	1298	-1	9
-1	3021	-1	2
-1	4464	-1	2
-1	4243	-1	9
-1	3263	-1	4
-1	3052	-1	10
-1	3160	-1	10
-1	1335	-1	5
-1	2897	-1	1
-1	1833	-1	7
-1	3974	-1	1
-1	2254	-1	4
-1	2042	-1	4
-1	2453	-1	7
-1	3768	-1	7
-1	1057	-1	4
-1	2575	-1	7
-1	1601	-1	4
-1	2261	-1	5
-1	2060	-1	6
-1	1902	-1	8
