80 20
1 87 2 87 3 60 4 59 5 51 6 70 7 32 8 11 9 65 10 46 11 43 12 80 13 28 14 59 15 55 16 60 17 21 18 24 19 94 20 97
1 87 2 5 3 60 4 44 5 5 6 64 7 95 8 14 9 64 10 72 11 69 12 22 13 19 14 88 15 7 16 76 17 16 18 82 19 80 20 58
1 33 2 39 3 1 4 98 5 79 6 54 7 40 8 33 9 62 10 72 11 38 12 95 13 99 14 28 15 77 16 5 17 35 18 44 19 70 20 73
1 92 2 45 3 46 4 32 5 9 6 33 7 59 8 55 9 32 10 28 11 89 12 42 13 5 14 58 15 58 16 64 17 41 18 94 19 98 20 98
1 95 2 58 3 28 4 30 5 73 6 36 7 7 8 8 9 2 10 14 11 83 12 88 13 13 14 65 15 60 16 74 17 62 18 43 19 26 20 55
1 8 2 66 3 5 4 24 5 22 6 35 7 61 8 50 9 78 10 19 11 70 12 42 13 72 14 38 15 75 16 64 17 31 18 56 19 20 20 95
1 26 2 89 3 8 4 34 5 1 6 45 7 25 8 57 9 61 10 14 11 71 12 50 13 36 14 38 15 24 16 58 17 91 18 61 19 1 20 37
1 42 2 27 3 87 4 44 5 58 6 93 7 19 8 53 9 20 10 86 11 53 12 74 13 89 14 56 15 19 16 80 17 4 18 47 19 57 20 80
1 12 2 62 3 21 4 69 5 4 6 89 7 64 8 44 9 64 10 42 11 83 12 21 13 63 14 68 15 9 16 18 17 2 18 15 19 40 20 71
1 88 2 67 3 40 4 57 5 81 6 43 7 30 8 20 9 77 10 86 11 4 12 81 13 8 14 47 15 37 16 8 17 41 18 73 19 19 20 60
1 57 2 68 3 80 4 2 5 42 6 96 7 38 8 84 9 12 10 78 11 15 12 53 13 5 14 66 15 42 16 58 17 46 18 27 19 37 20 82
1 69 2 98 3 45 4 43 5 45 6 78 7 61 8 98 9 15 10 28 11 9 12 25 13 2 14 12 15 9 16 42 17 88 18 50 19 53 20 17
1 25 2 43 3 41 4 16 5 44 6 7 7 55 8 64 9 64 10 59 11 76 12 43 13 20 14 36 15 36 16 32 17 71 18 75 19 60 20 24
1 12 2 66 3 42 4 39 5 82 6 5 7 99 8 11 9 24 10 47 11 70 12 7 13 29 14 57 15 17 16 13 17 36 18 48 19 43 20 59
1 57 2 95 3 33 4 49 5 50 6 89 7 58 8 86 9 56 10 71 11 81 12 14 13 7 14 21 15 91 16 60 17 47 18 79 19 22 20 50
1 12 2 83 3 59 4 93 5 55 6 73 7 47 8 51 9 43 10 45 11 71 12 4 13 40 14 47 15 36 16 5 17 53 18 3 19 71 20 12
1 87 2 82 3 57 4 38 5 84 6 57 7 7 8 76 9 93 10 73 11 27 12 96 13 63 14 75 15 27 16 21 17 14 18 63 19 88 20 2
1 89 2 90 3 46 4 91 5 58 6 70 7 57 8 45 9 12 10 69 11 67 12 3 13 30 14 81 15 8 16 73 17 58 18 68 19 39 20 11
1 50 2 92 3 73 4 13 5 44 6 60 7 36 8 89 9 24 10 4 11 91 12 85 13 77 14 64 15 89 16 14 17 2 18 55 19 98 20 57
1 19 2 26 3 3 4 74 5 15 6 88 7 6 8 22 9 59 10 32 11 17 12 10 13 96 14 83 15 23 16 73 17 38 18 14 19 31 20 24
1 2 2 89 3 25 4 39 5 79 6 71 7 66 8 66 9 62 10 54 11 83 12 27 13 53 14 80 15 53 16 7 17 57 18 37 19 69 20 14
1 47 2 36 3 32 4 52 5 44 6 60 7 69 8 16 9 38 10 64 11 36 12 68 13 10 14 90 15 60 16 8 17 50 18 30 19 33 20 29
1 6 2 31 3 21 4 44 5 29 6 94 7 92 8 59 9 20 10 89 11 59 12 27 13 51 14 96 15 52 16 3 17 90 18 49 19 56 20 35
1 23 2 50 3 88 4 19 5 11 6 9 7 75 8 42 9 74 10 75 11 59 12 43 13 78 14 9 15 42 16 49 17 40 18 92 19 18 20 40
1 70 2 80 3 47 4 62 5 69 6 99 7 44 8 86 9 14 10 79 11 77 12 30 13 60 14 86 15 75 16 16 17 96 18 80 19 31 20 23
1 19 2 32 3 44 4 32 5 53 6 95 7 66 8 56 9 79 10 27 11 44 12 72 13 50 14 91 15 50 16 59 17 59 18 27 19 34 20 40
1 10 2 78 3 89 4 78 5 10 6 80 7 76 8 95 9 9 10 51 11 31 12 61 13 59 14 39 15 97 16 20 17 52 18 15 19 89 20 47
1 4 2 79 3 1 4 93 5 81 6 18 7 80 8 50 9 90 10 6 11 23 12 37 13 31 14 48 15 79 16 98 17 2 18 50 19 99 20 63
1 44 2 88 3 98 4 86 5 80 6 33 7 47 8 25 9 61 10 15 11 39 12 3 13 44 14 58 15 85 16 50 17 18 18 17 19 90 20 26
1 41 2 21 3 57 4 82 5 83 6 3 7 59 8 74 9 26 10 82 11 3 12 81 13 16 14 74 15 12 16 21 17 31 18 24 19 67 20 23
1 4 2 50 3 23 4 80 5 62 6 13 7 61 8 1 9 79 10 59 11 34 12 76 13 28 14 79 15 9 16 27 17 5 18 41 19 33 20 91
1 24 2 98 3 83 4 83 5 82 6 61 7 11 8 87 9 44 10 68 11 31 12 38 13 5 14 35 15 20 16 9 17 37 18 61 19 73 20 91
1 56 2 75 3 22 4 14 5 33 6 10 7 58 8 22 9 83 10 14 11 83 12 6 13 57 14 14 15 62 16 53 17 73 18 7 19 11 20 88
1 45 2 59 3 45 4 34 5 12 6 18 7 60 8 87 9 81 10 99 11 69 12 9 13 20 14 75 15 17 16 97 17 29 18 26 19 93 20 99
1 60 2 64 3 69 4 40 5 44 6 47 7 20 8 29 9 69 10 89 11 85 12 83 13 93 14 13 15 41 16 91 17 95 18 3 19 89 20 54
1 60 2 30 3 6 4 10 5 17 6 5 7 83 8 49 9 47 10 44 11 36 12 15 13 7 14 52 15 40 16 11 17 29 18 37 19 78 20 24
1 18 2 32 3 92 4 3 5 40 6 14 7 62 8 91 9 20 10 88 11 59 12 30 13 15 14 97 15 46 16 25 17 28 18 30 19 45 20 26
1 89 2 32 3 44 4 77 5 57 6 88 7 18 8 79 9 73 10 66 11 63 12 7 13 20 14 71 15 41 16 71 17 69 18 75 19 36 20 71
1 75 2 96 3 67 4 96 5 95 6 92 7 35 8 97 9 4 10 73 11 37 12 43 13 77 14 92 15 3 16 26 17 23 18 35 19 90 20 82
1 30 2 15 3 80 4 36 5 96 6 62 7 24 8 99 9 47 10 74 11 67 12 26 13 65 14 9 15 66 16 40 17 11 18 9 19 31 20 41
1 9 2 56 3 22 4 81 5 35 6 77 7 86 8 81 9 68 10 91 11 90 12 8 13 72 14 77 15 26 16 98 17 96 18 73 19 65 20 93
1 5 2 99 3 59 4 29 5 48 6 71 7 30 8 22 9 72 10 48 11 8 12 48 13 76 14 59 15 11 16 74 17 55 18 75 19 44 20 92
1 40 2 99 3 39 4 67 5 78 6 78 7 31 8 30 9 11 10 17 11 11 12 14 13 17 14 63 15 77 16 19 17 84 18 15 19 57 20 21
1 90 2 1 3 41 4 54 5 15 6 27 7 34 8 78 9 19 10 94 11 10 12 4 13 76 14 69 15 10 16 41 17 87 18 3 19 99 20 48
1 57 2 43 3 6 4 40 5 17 6 9 7 10 8 25 9 76 10 61 11 95 12 38 13 6 14 92 15 42 16 10 17 56 18 36 19 59 20 12
1 90 2 43 3 98 4 25 5 96 6 97 7 40 8 13 9 73 10 41 11 60 12 25 13 49 14 72 15 19 16 29 17 98 18 54 19 65 20 99
1 20 2 15 3 56 4 30 5 64 6 20 7 3 8 22 9 32 10 43 11 91 12 67 13 78 14 2 15 76 16 3 17 56 18 28 19 86 20 91
1 31 2 73 3 29 4 50 5 70 6 45 7 91 8 23 9 38 10 83 11 48 12 35 13 5 14 73 15 96 16 72 17 87 18 25 19 4 20 69
1 98 2 95 3 69 4 20 5 37 6 62 7 36 8 27 9 66 10 20 11 73 12 22 13 33 14 6 15 72 16 35 17 62 18 5 19 18 20 65
1 97 2 97 3 54 4 15 5 70 6 7 7 45 8 95 9 2 10 97 11 14 12 16 13 98 14 66 15 55 16 95 17 24 18 92 19 52 20 69
1 94 2 88 3 94 4 87 5 42 6 33 7 96 8 27 9 27 10 93 11 84 12 44 13 71 14 30 15 41 16 12 17 93 18 61 19 34 20 68
1 36 2 52 3 26 4 98 5 2 6 80 7 86 8 19 9 59 10 35 11 75 12 73 13 68 14 42 15 49 16 94 17 3 18 16 19 32 20 75
1 34 2 61 3 6 4 46 5 1 6 50 7 64 8 68 9 81 10 27 11 71 12 95 13 54 14 86 15 34 16 98 17 37 18 85 19 37 20 67
1 35 2 10 3 28 4 5 5 29 6 49 7 70 8 85 9 8 10 39 11 79 12 72 13 40 14 45 15 48 16 54 17 7 18 47 19 90 20 86
1 52 2 8 3 87 4 49 5 25 6 82 7 15 8 30 9 20 10 90 11 20 12 12 13 48 14 67 15 99 16 89 17 21 18 88 19 96 20 23
1 22 2 13 3 94 4 93 5 23 6 38 7 63 8 1 9 52 10 17 11 50 12 51 13 78 14 69 15 79 16 75 17 4 18 95 19 79 20 7
1 33 2 52 3 95 4 54 5 31 6 92 7 54 8 91 9 90 10 13 11 30 12 61 13 7 14 10 15 59 16 34 17 53 18 23 19 2 20 50
1 19 2 74 3 8 4 86 5 43 6 78 7 34 8 53 9 43 10 57 11 41 12 37 13 50 14 82 15 42 16 43 17 62 18 58 19 93 20 57
1 35 2 49 3 16 4 18 5 48 6 19 7 15 8 12 9 61 10 23 11 78 12 33 13 77 14 10 15 2 16 35 17 79 18 57 19 80 20 13
1 75 2 24 3 5 4 79 5 7 6 42 7 76 8 55 9 48 10 55 11 56 12 39 13 4 14 75 15 5 16 68 17 72 18 71 19 33 20 35
1 93 2 18 3 15 4 69 5 69 6 70 7 59 8 7 9 43 10 34 11 77 12 63 13 28 14 21 15 78 16 54 17 89 18 33 19 37 20 22
1 87 2 82 3 4 4 8 5 56 6 29 7 28 8 64 9 59 10 77 11 26 12 97 13 62 14 13 15 5 16 16 17 80 18 25 19 41 20 66
1 48 2 96 3 58 4 50 5 37 6 40 7 83 8 65 9 4 10 98 11 17 12 3 13 76 14 94 15 72 16 34 17 61 18 7 19 81 20 20
1 97 2 35 3 49 4 32 5 95 6 83 7 52 8 62 9 33 10 35 11 93 12 28 13 99 14 96 15 20 16 1 17 28 18 46 19 89 20 81
1 24 2 78 3 45 4 80 5 10 6 79 7 19 8 67 9 46 10 91 11 42 12 79 13 45 14 67 15 82 16 54 17 51 18 11 19 17 20 87
1 23 2 4 3 59 4 88 5 71 6 18 7 34 8 41 9 8 10 30 11 2 12 94 13 9 14 59 15 67 16 39 17 51 18 89 19 65 20 41
1 36 2 62 3 44 4 20 5 29 6 78 7 46 8 60 9 20 10 19 11 96 12 39 13 86 14 33 15 18 16 1 17 30 18 71 19 13 20 9
1 55 2 6 3 25 4 72 5 65 6 4 7 1 8 34 9 65 10 69 11 86 12 83 13 1 14 51 15 9 16 33 17 53 18 54 19 42 20 95
1 74 2 76 3 94 4 91 5 89 6 60 7 18 8 70 9 17 10 59 11 71 12 71 13 13 14 42 15 63 16 24 17 37 18 42 19 12 20 19
1 39 2 12 3 16 4 82 5 26 6 51 7 42 8 92 9 89 10 65 11 97 12 9 13 47 14 84 15 16 16 3 17 64 18 13 19 40 20 25
1 55 2 15 3 20 4 8 5 31 6 1 7 67 8 34 9 32 10 97 11 67 12 68 13 50 14 94 15 71 16 72 17 86 18 54 19 5 20 54
1 44 2 88 3 49 4 76 5 39 6 92 7 93 8 31 9 15 10 74 11 71 12 67 13 12 14 79 15 66 16 9 17 93 18 71 19 51 20 3
1 25 2 45 3 66 4 68 5 36 6 60 7 57 8 89 9 68 10 71 11 23 12 96 13 48 14 14 15 49 16 45 17 64 18 9 19 91 20 67
1 72 2 18 3 58 4 84 5 46 6 86 7 5 8 72 9 47 10 67 11 50 12 6 13 36 14 89 15 78 16 33 17 44 18 28 19 95 20 97
1 59 2 52 3 25 4 71 5 66 6 34 7 65 8 73 9 21 10 74 11 87 12 61 13 83 14 47 15 83 16 4 17 27 18 68 19 80 20 72
1 37 2 15 3 47 4 97 5 10 6 80 7 44 8 23 9 21 10 34 11 22 12 71 13 34 14 78 15 93 16 66 17 92 18 94 19 39 20 81
1 73 2 38 3 58 4 8 5 80 6 59 7 19 8 25 9 92 10 87 11 5 12 6 13 42 14 50 15 58 16 39 17 22 18 84 19 98 20 69
1 16 2 79 3 20 4 13 5 6 6 82 7 75 8 85 9 38 10 90 11 77 12 90 13 32 14 64 15 65 16 70 17 65 18 42 19 59 20 3
1 14 2 63 3 97 4 7 5 9 6 18 7 89 8 54 9 71 10 16 11 32 12 1 13 76 14 24 15 72 16 31 17 23 18 74 19 43 20 87
1 93 2 90 3 27 4 69 5 20 6 84 7 18 8 45 9 75 10 6 11 1 12 4 13 6 14 92 15 59 16 9 17 1 18 59 19 82 20 69
Reldue
-1	4347	-1	2
-1	2125	-1	4
-1	1752	-1	2
-1	4088	-1	7
-1	3384	-1	7
-1	2041	-1	10
-1	2123	-1	10
-1	3478	-1	7
-1	2657	-1	6
-1	2309	-1	4
-1	2316	-1	8
-1	1637	-1	9
-1	3122	-1	4
-1	2384	-1	9
-1	3030	-1	5
-1	2453	-1	8
-1	4270	-1	7
-1	2401	-1	9
-1	4199	-1	1
-1	1460	-1	2
-1	1631	-1	7
-1	1216	-1	4
-1	1518	-1	5
-1	3379	-1	5
-1	4556	-1	3
-1	2534	-1	8
-1	1274	-1	7
-1	1072	-1	8
-1	3212	-1	3
-1	3261	-1	10
-1	1961	-1	1
-1	3254	-1	7
-1	2633	-1	7
-1	4242	-1	8
-1	3908	-1	5
-1	956	-1	5
-1	1606	-1	6
-1	1599	-1	8
-1	4745	-1	3
-1	1424	-1	4
-1	2100	-1	5
-1	3027	-1	9
-1	2881	-1	9
-1	3379	-1	1
-1	2190	-1	5
-1	3390	-1	4
-1	1921	-1	6
-1	2130	-1	5
-1	1873	-1	5
-1	3573	-1	6
-1	1504	-1	7
-1	3473	-1	8
-1	2789	-1	9
-1	2894	-1	8
-1	2041	-1	9
-1	1435	-1	7
-1	2498	-1	3
-1	1874	-1	6
-1	1370	-1	5
-1	1821	-1	4
-1	1368	-1	6
-1	2403	-1	5
-1	3505	-1	8
-1	4514	-1	7
-1	3861	-1	10
-1	3529	-1	4
-1	3224	-1	4
-1	1815	-1	1
-1	1425	-1	8
-1	2436	-1	6
-1	2824	-1	8
-1	3743	-1	6
-1	3179	-1	2
-1	1195	-1	5
-1	1437	-1	6
-1	4301	-1	4
-1	1200	-1	8
-1	1366	-1	1
-1	1135	-1	10
-1	1517	-1	9
