90 20
1 63 2 33 3 99 4 3 5 61 6 1 7 41 8 92 9 25 10 43 11 8 12 29 13 73 14 68 15 73 16 53 17 95 18 89 19 27 20 52
1 98 2 14 3 6 4 46 5 67 6 34 7 42 8 33 9 77 10 2 11 19 12 34 13 85 14 44 15 84 16 22 17 58 18 47 19 86 20 51
1 58 2 86 3 80 4 56 5 66 6 52 7 65 8 66 9 91 10 58 11 82 12 46 13 82 14 25 15 48 16 7 17 55 18 38 19 13 20 28
1 85 2 21 3 42 4 73 5 51 6 57 7 33 8 48 9 60 10 92 11 32 12 53 13 74 14 7 15 49 16 91 17 49 18 89 19 11 20 54
1 88 2 66 3 17 4 27 5 24 6 63 7 81 8 60 9 20 10 9 11 57 12 97 13 14 14 15 15 17 16 4 17 19 18 82 19 57 20 95
1 70 2 96 3 65 4 92 5 82 6 77 7 40 8 78 9 33 10 54 11 56 12 60 13 47 14 1 15 14 16 25 17 93 18 40 19 51 20 74
1 25 2 48 3 35 4 99 5 52 6 16 7 97 8 89 9 52 10 87 11 81 12 99 13 14 14 40 15 2 16 39 17 64 18 75 19 62 20 71
1 84 2 46 3 57 4 72 5 80 6 13 7 71 8 16 9 66 10 41 11 42 12 83 13 39 14 79 15 36 16 34 17 93 18 57 19 66 20 44
1 19 2 80 3 73 4 58 5 11 6 94 7 71 8 29 9 8 10 17 11 48 12 96 13 21 14 73 15 89 16 67 17 35 18 85 19 95 20 10
1 18 2 34 3 69 4 74 5 16 6 24 7 78 8 41 9 33 10 42 11 7 12 30 13 70 14 75 15 30 16 53 17 4 18 95 19 5 20 11
1 38 2 99 3 37 4 46 5 79 6 39 7 77 8 15 9 81 10 68 11 60 12 36 13 78 14 63 15 49 16 47 17 67 18 14 19 86 20 76
1 96 2 81 3 21 4 63 5 99 6 65 7 90 8 65 9 89 10 27 11 9 12 30 13 62 14 6 15 40 16 6 17 11 18 28 19 66 20 95
1 36 2 35 3 24 4 19 5 73 6 16 7 61 8 96 9 62 10 51 11 27 12 15 13 85 14 42 15 23 16 13 17 31 18 36 19 37 20 61
1 30 2 91 3 61 4 7 5 3 6 9 7 40 8 46 9 91 10 34 11 99 12 9 13 50 14 82 15 25 16 52 17 65 18 41 19 53 20 68
1 80 2 98 3 86 4 56 5 26 6 30 7 78 8 24 9 54 10 6 11 19 12 19 13 53 14 46 15 32 16 52 17 63 18 71 19 65 20 91
1 95 2 83 3 51 4 94 5 83 6 21 7 80 8 42 9 17 10 6 11 43 12 36 13 86 14 99 15 68 16 90 17 2 18 31 19 75 20 91
1 24 2 74 3 93 4 25 5 54 6 46 7 16 8 81 9 27 10 84 11 29 12 53 13 87 14 10 15 60 16 45 17 21 18 8 19 57 20 53
1 65 2 76 3 6 4 76 5 89 6 96 7 69 8 38 9 35 10 79 11 17 12 7 13 30 14 80 15 89 16 73 17 68 18 96 19 44 20 56
1 84 2 67 3 25 4 29 5 34 6 14 7 18 8 91 9 72 10 90 11 4 12 64 13 14 14 60 15 72 16 1 17 62 18 75 19 74 20 67
1 38 2 67 3 5 4 72 5 74 6 68 7 35 8 55 9 90 10 38 11 57 12 26 13 11 14 43 15 72 16 33 17 53 18 34 19 25 20 13
1 46 2 31 3 79 4 33 5 37 6 48 7 53 8 58 9 17 10 96 11 10 12 7 13 22 14 13 15 3 16 99 17 53 18 38 19 13 20 36
1 93 2 30 3 83 4 35 5 25 6 29 7 72 8 56 9 50 10 81 11 80 12 2 13 78 14 1 15 2 16 68 17 1 18 11 19 67 20 51
1 6 2 63 3 34 4 93 5 63 6 3 7 83 8 85 9 1 10 87 11 86 12 76 13 65 14 67 15 61 16 71 17 67 18 45 19 37 20 27
1 67 2 51 3 96 4 3 5 13 6 44 7 38 8 39 9 55 10 48 11 80 12 50 13 54 14 83 15 85 16 78 17 54 18 57 19 21 20 15
1 17 2 58 3 15 4 86 5 55 6 63 7 9 8 35 9 41 10 14 11 49 12 24 13 61 14 57 15 21 16 61 17 49 18 52 19 38 20 42
1 53 2 7 3 23 4 8 5 13 6 36 7 1 8 40 9 57 10 99 11 5 12 76 13 59 14 22 15 76 16 69 17 27 18 93 19 82 20 41
1 49 2 14 3 48 4 11 5 30 6 82 7 48 8 6 9 36 10 6 11 99 12 6 13 95 14 75 15 2 16 46 17 14 18 32 19 69 20 78
1 94 2 16 3 48 4 75 5 27 6 51 7 90 8 75 9 78 10 59 11 30 12 34 13 7 14 37 15 93 16 2 17 50 18 85 19 89 20 52
1 42 2 32 3 2 4 53 5 45 6 68 7 43 8 95 9 63 10 74 11 49 12 64 13 20 14 73 15 82 16 46 17 98 18 93 19 73 20 11
1 24 2 97 3 92 4 11 5 56 6 92 7 47 8 64 9 8 10 31 11 99 12 35 13 8 14 33 15 86 16 66 17 31 18 75 19 56 20 13
1 39 2 55 3 14 4 81 5 89 6 68 7 27 8 5 9 41 10 13 11 52 12 13 13 65 14 78 15 28 16 63 17 53 18 84 19 12 20 96
1 39 2 48 3 26 4 84 5 81 6 32 7 79 8 80 9 20 10 47 11 11 12 92 13 78 14 21 15 61 16 72 17 46 18 91 19 63 20 35
1 49 2 1 3 73 4 97 5 38 6 62 7 43 8 12 9 68 10 61 11 58 12 39 13 26 14 48 15 2 16 12 17 65 18 69 19 75 20 93
1 40 2 81 3 22 4 89 5 96 6 52 7 7 8 90 9 93 10 48 11 95 12 29 13 18 14 61 15 20 16 38 17 90 18 37 19 77 20 27
1 12 2 12 3 11 4 4 5 39 6 11 7 42 8 81 9 13 10 4 11 53 12 66 13 26 14 95 15 47 16 78 17 39 18 71 19 26 20 50
1 46 2 86 3 11 4 38 5 74 6 44 7 34 8 9 9 75 10 38 11 53 12 77 13 47 14 9 15 2 16 66 17 94 18 75 19 51 20 94
1 65 2 38 3 74 4 67 5 49 6 72 7 25 8 34 9 60 10 79 11 47 12 28 13 34 14 86 15 24 16 50 17 29 18 72 19 78 20 51
1 21 2 34 3 47 4 35 5 38 6 16 7 48 8 99 9 34 10 11 11 49 12 69 13 86 14 53 15 48 16 56 17 68 18 89 19 13 20 99
1 52 2 70 3 99 4 4 5 78 6 75 7 28 8 41 9 54 10 29 11 77 12 65 13 78 14 54 15 42 16 88 17 36 18 63 19 14 20 16
1 70 2 13 3 72 4 72 5 39 6 12 7 92 8 80 9 52 10 86 11 50 12 22 13 26 14 57 15 21 16 89 17 30 18 98 19 57 20 3
1 68 2 91 3 9 4 20 5 34 6 21 7 64 8 61 9 52 10 94 11 61 12 78 13 72 14 73 15 93 16 11 17 88 18 20 19 17 20 69
1 78 2 3 3 11 4 40 5 18 6 93 7 52 8 3 9 85 10 7 11 1 12 7 13 95 14 57 15 71 16 16 17 45 18 33 19 84 20 84
1 75 2 27 3 64 4 46 5 73 6 18 7 39 8 33 9 29 10 12 11 69 12 1 13 91 14 95 15 2 16 45 17 28 18 82 19 93 20 95
1 96 2 68 3 27 4 48 5 67 6 68 7 79 8 58 9 48 10 66 11 60 12 32 13 79 14 73 15 10 16 12 17 49 18 50 19 37 20 79
1 3 2 97 3 50 4 71 5 95 6 63 7 91 8 2 9 33 10 53 11 72 12 4 13 5 14 71 15 40 16 32 17 6 18 70 19 79 20 53
1 11 2 6 3 99 4 13 5 50 6 89 7 3 8 29 9 63 10 74 11 72 12 48 13 66 14 55 15 56 16 97 17 96 18 49 19 13 20 66
1 57 2 79 3 34 4 93 5 69 6 93 7 25 8 78 9 55 10 48 11 97 12 7 13 65 14 1 15 51 16 40 17 71 18 24 19 48 20 87
1 30 2 31 3 48 4 99 5 96 6 34 7 69 8 21 9 72 10 88 11 76 12 14 13 8 14 7 15 4 16 4 17 8 18 82 19 37 20 85
1 36 2 81 3 27 4 33 5 34 6 41 7 21 8 86 9 70 10 37 11 26 12 21 13 87 14 85 15 82 16 74 17 9 18 10 19 56 20 49
1 41 2 8 3 13 4 87 5 74 6 48 7 34 8 94 9 34 10 76 11 28 12 71 13 1 14 79 15 72 16 30 17 84 18 7 19 27 20 27
1 72 2 99 3 55 4 19 5 44 6 54 7 60 8 90 9 22 10 50 11 41 12 13 13 87 14 23 15 88 16 94 17 1 18 62 19 78 20 94
1 43 2 91 3 43 4 53 5 53 6 55 7 62 8 40 9 99 10 55 11 44 12 58 13 70 14 71 15 32 16 33 17 72 18 85 19 79 20 46
1 55 2 86 3 72 4 65 5 57 6 47 7 30 8 54 9 36 10 19 11 40 12 74 13 48 14 45 15 4 16 2 17 99 18 81 19 65 20 68
1 51 2 65 3 96 4 58 5 93 6 4 7 65 8 99 9 10 10 99 11 46 12 58 13 83 14 18 15 58 16 42 17 94 18 55 19 30 20 75
1 50 2 88 3 20 4 51 5 95 6 3 7 19 8 22 9 16 10 33 11 29 12 73 13 44 14 16 15 73 16 16 17 90 18 2 19 79 20 51
1 39 2 85 3 85 4 6 5 38 6 64 7 33 8 97 9 22 10 74 11 99 12 6 13 19 14 55 15 3 16 30 17 75 18 79 19 74 20 14
1 73 2 30 3 54 4 38 5 48 6 88 7 63 8 83 9 26 10 14 11 42 12 27 13 70 14 71 15 97 16 92 17 29 18 19 19 20 20 93
1 15 2 56 3 60 4 33 5 50 6 39 7 63 8 86 9 8 10 49 11 72 12 41 13 61 14 16 15 69 16 20 17 13 18 47 19 91 20 63
1 71 2 66 3 71 4 64 5 90 6 95 7 95 8 74 9 92 10 83 11 74 12 87 13 7 14 86 15 35 16 61 17 60 18 15 19 66 20 17
1 96 2 99 3 9 4 42 5 45 6 89 7 26 8 52 9 77 10 17 11 93 12 64 13 42 14 49 15 40 16 95 17 67 18 11 19 85 20 85
1 61 2 93 3 92 4 72 5 1 6 63 7 93 8 71 9 60 10 90 11 20 12 99 13 79 14 56 15 26 16 30 17 58 18 49 19 76 20 43
1 49 2 93 3 11 4 52 5 13 6 60 7 59 8 15 9 40 10 30 11 35 12 8 13 81 14 62 15 16 16 14 17 17 18 3 19 67 20 40
1 47 2 36 3 79 4 42 5 64 6 82 7 87 8 40 9 33 10 94 11 4 12 58 13 53 14 25 15 60 16 8 17 67 18 18 19 49 20 24
1 79 2 64 3 33 4 64 5 19 6 51 7 37 8 21 9 20 10 1 11 98 12 43 13 75 14 87 15 31 16 74 17 69 18 66 19 83 20 41
1 71 2 46 3 86 4 83 5 5 6 73 7 16 8 23 9 51 10 84 11 61 12 30 13 34 14 34 15 4 16 61 17 28 18 33 19 91 20 72
1 50 2 58 3 1 4 33 5 52 6 62 7 99 8 7 9 65 10 81 11 9 12 7 13 22 14 4 15 73 16 38 17 98 18 91 19 93 20 23
1 71 2 59 3 21 4 63 5 59 6 12 7 51 8 95 9 99 10 91 11 58 12 72 13 11 14 23 15 2 16 27 17 96 18 41 19 32 20 97
1 92 2 18 3 83 4 46 5 91 6 58 7 1 8 64 9 43 10 40 11 10 12 42 13 35 14 9 15 21 16 36 17 53 18 55 19 70 20 31
1 68 2 63 3 83 4 17 5 72 6 46 7 89 8 90 9 13 10 38 11 91 12 61 13 93 14 64 15 40 16 85 17 39 18 74 19 24 20 56
1 74 2 76 3 40 4 53 5 41 6 36 7 5 8 52 9 43 10 16 11 13 12 44 13 14 14 23 15 14 16 53 17 1 18 13 19 53 20 87
1 33 2 24 3 92 4 15 5 49 6 93 7 38 8 21 9 86 10 67 11 97 12 39 13 66 14 41 15 29 16 59 17 73 18 99 19 30 20 33
1 52 2 37 3 26 4 64 5 99 6 35 7 89 8 94 9 37 10 95 11 60 12 37 13 62 14 82 15 13 16 69 17 65 18 28 19 30 20 35
1 7 2 53 3 40 4 70 5 89 6 68 7 72 8 90 9 62 10 48 11 91 12 2 13 60 14 88 15 66 16 59 17 88 18 95 19 72 20 81
1 51 2 56 3 9 4 42 5 60 6 12 7 61 8 34 9 94 10 66 11 5 12 90 13 32 14 8 15 61 16 38 17 24 18 17 19 73 20 51
1 22 2 55 3 92 4 11 5 1 6 90 7 41 8 30 9 19 10 5 11 72 12 1 13 7 14 74 15 50 16 83 17 23 18 22 19 1 20 54
1 64 2 62 3 42 4 86 5 43 6 46 7 76 8 28 9 95 10 29 11 46 12 92 13 99 14 29 15 13 16 91 17 67 18 98 19 63 20 89
1 27 2 20 3 14 4 86 5 86 6 11 7 66 8 56 9 50 10 72 11 71 12 29 13 83 14 3 15 11 16 45 17 59 18 29 19 69 20 52
1 97 2 21 3 52 4 26 5 24 6 74 7 21 8 85 9 13 10 35 11 39 12 58 13 1 14 30 15 96 16 85 17 4 18 12 19 53 20 51
1 48 2 60 3 78 4 69 5 96 6 38 7 27 8 5 9 58 10 57 11 87 12 81 13 23 14 5 15 97 16 22 17 28 18 78 19 60 20 52
1 33 2 88 3 49 4 39 5 8 6 62 7 9 8 31 9 36 10 9 11 99 12 78 13 76 14 56 15 16 16 84 17 28 18 97 19 27 20 63
1 10 2 2 3 58 4 46 5 79 6 30 7 86 8 19 9 69 10 2 11 56 12 96 13 92 14 83 15 29 16 45 17 83 18 32 19 59 20 9
1 82 2 28 3 76 4 20 5 90 6 4 7 49 8 23 9 98 10 64 11 29 12 96 13 68 14 74 15 71 16 41 17 90 18 70 19 26 20 59
1 49 2 38 3 50 4 71 5 27 6 82 7 74 8 93 9 33 10 74 11 93 12 63 13 24 14 95 15 7 16 64 17 16 18 34 19 33 20 41
1 38 2 24 3 97 4 52 5 40 6 46 7 56 8 48 9 66 10 72 11 11 12 42 13 47 14 38 15 99 16 36 17 86 18 53 19 59 20 91
1 89 2 72 3 71 4 30 5 83 6 49 7 13 8 56 9 61 10 13 11 68 12 84 13 17 14 2 15 11 16 76 17 44 18 17 19 8 20 6
1 13 2 70 3 17 4 97 5 35 6 37 7 99 8 79 9 23 10 69 11 53 12 9 13 93 14 98 15 20 16 11 17 42 18 37 19 33 20 80
1 67 2 9 3 37 4 30 5 55 6 97 7 37 8 52 9 80 10 73 11 8 12 83 13 52 14 45 15 56 16 89 17 82 18 58 19 20 20 16
1 49 2 18 3 31 4 50 5 86 6 83 7 18 8 83 9 23 10 75 11 95 12 55 13 84 14 17 15 61 16 36 17 67 18 52 19 99 20 14
1 71 2 3 3 77 4 45 5 78 6 90 7 98 8 90 9 26 10 18 11 65 12 43 13 47 14 45 15 27 16 23 17 6 18 3 19 82 20 68
1 45 2 96 3 59 4 21 5 86 6 14 7 78 8 57 9 75 10 4 11 71 12 5 13 81 14 68 15 85 16 92 17 39 18 10 19 5 20 3
Reldue
-1	2547	-1	6
-1	2487	-1	4
-1	3882	-1	7
-1	2462	-1	2
-1	1427	-1	4
-1	4192	-1	3
-1	3843	-1	9
-1	3347	-1	8
-1	4110	-1	3
-1	3036	-1	2
-1	3131	-1	3
-1	2096	-1	1
-1	2217	-1	9
-1	2691	-1	4
-1	4110	-1	8
-1	4439	-1	7
-1	2742	-1	7
-1	4221	-1	3
-1	3680	-1	8
-1	2811	-1	8
-1	1582	-1	2
-1	1253	-1	1
-1	3489	-1	9
-1	2615	-1	10
-1	3077	-1	10
-1	1758	-1	5
-1	3177	-1	5
-1	3296	-1	4
-1	2674	-1	8
-1	1947	-1	4
-1	1100	-1	1
-1	1219	-1	9
-1	3722	-1	3
-1	1671	-1	5
-1	1747	-1	4
-1	3511	-1	6
-1	3629	-1	8
-1	3943	-1	4
-1	2430	-1	8
-1	2176	-1	2
-1	2692	-1	7
-1	3283	-1	3
-1	1670	-1	10
-1	2331	-1	6
-1	1027	-1	9
-1	3780	-1	8
-1	3118	-1	7
-1	3590	-1	7
-1	3030	-1	8
-1	1766	-1	5
-1	3502	-1	9
-1	2900	-1	7
-1	1204	-1	4
-1	1775	-1	2
-1	2920	-1	3
-1	2908	-1	7
-1	3613	-1	9
-1	3672	-1	9
-1	5111	-1	1
-1	1613	-1	6
-1	2168	-1	8
-1	2972	-1	5
-1	2358	-1	9
-1	2118	-1	8
-1	2910	-1	2
-1	2674	-1	8
-1	1478	-1	3
-1	2310	-1	2
-1	1383	-1	2
-1	1813	-1	4
-1	1169	-1	4
-1	3364	-1	5
-1	4728	-1	9
-1	3172	-1	3
-1	1357	-1	5
-1	2978	-1	7
-1	3402	-1	6
-1	918	-1	2
-1	1461	-1	9
-1	1668	-1	6
-1	1296	-1	1
-1	2746	-1	6
-1	1322	-1	4
-1	4301	-1	7
-1	1343	-1	4
-1	3658	-1	5
-1	3430	-1	10
-1	2686	-1	7
-1	1066	-1	5
-1	1202	-1	10
